este	j e s t e
treaba	t r e@ a b a
constituție	k o n s t i t u ts i e
avem	a v e m
timpul	t i m p u l
minge	m i n dz e
nicoară	n i k o@ a r @
crede	k r e d e
acest	a ch e s t
concurs	k o n k u r s
avea	a v e@ a
afganistanul	a f g a n i s t a n u l
reprezentat	r e p r e z e n t a t
adunarea	a d u n a r e@ a
generală	dz e n e r a l @
ministrul	m i n i s t r u l
externe	e k s t e r n e
declarat	d e k l a r a t
responsabil	r e s p o n s a b i l
misiunii	m i s i u n i j
evenimentul	e v e n i m e n t u l
scop	s k o p
schimbului	s k i m b u l u j
idei	i d e j
privind	p r i v i n d
viitorul	v i j t o r u l
securității	s e k u r i t @ ts i j
energetice	e n e r dz e t i ch e
aceste	a ch e s t e
regiuni	r e dz i u n ij
serviciu	s e r v i ch i w
dimineața	d i m i n e@ a ts a
acasă	a k a s @
seara	s e@ a r a
intervenit	i n t e r v e n i t
aplanez	a p l a n e z
conflictul	k o n f l i k t u l
dacă	d a k @
lucrurile	l u k r u r i l e
scapă	s k a p @
control	k o n t r o l
atenție	a t e n ts i e
sunt	s u n t
șeful	sh e f u l
domnul	d o m n u l
bergodi	b e r g o d i
bine	b i n e
venit	v e n i t
meci	m e ch i
chiar	k i a r
dumnealui	d u m n e@ a l u j
face	f a ch e
parte	p a r t e
staf	s t a f
contrar	k o n t r a r
amânarea	a m a@ n a r e@ a
prezentului	p r e z e n t u l u j
ratez	r a t e z
meciul	m e ch j u l
rapid	r a p i d
cupa	k u p a
româniei	r o m a@ n i e j
americanii	a m e r i k a n i j
însă	a@ n s @
hotărât	h o t @ r a@ t
urmez	u r m e z
militară	m i l i t a r @
acele	a ch e l e
tatuaje	t a t w a zh e
minciună	m i n ch i u n @
continuat	k o n t i n w a t
studiile	s t u d i i l e
acel	a ch e l
restaurant	r e s t a u r a n t
asigurată	a s i g u r a t @
masa	m a s a
care	k a r e
doar	d o@ a r
cuvinte	k u v i n t e
laudă	l a w d @
despre	d e s p r e
fostul	f o s t u l
patron	p a t r o n
vina	v i n a
oamenilor	o@ a m e n i l o r
lucru	l u k r u
schimb	s k i m b
podul	p o d u l
cheltuiala	k e l t u j a l a
multe	m u l t e
jucam	zh u k a m
fotbal	f o t b a l
mingea	m i n dz e@ a
tenis	t e n i s
plac	p l a k
foarte	f o@ a r t e
mult	m u l t
cățeii	k @ ts e j i
rămâne	r @ m a@ n e
libertate	l i b e r t a t e
timp	t i m p
trei	t r e j
luni	l u n ij
pentru	p e n t r u
tratamente	t r a t a m e n t e
medicale	m e d i k a l e
data	d a t a
zece	z e ch e
octombrie	o k t o m b r i e
depozitele	d e p o z i t e l e
gaze	g a z e
românia	r o m a@ n i a
pline	p l i n e
ochi	o k i
altfel	a l t f e l
cred	k r e d
realitățile	r e@ a l i t @ ts i l e
schimba	s k i m b a
redescoperi	r e d e s k o p e r i
marx	m a r k s
statelor	s t a t e l o r
unite	u n i t e
mark	m a r k
mulți	m u l ts ij
zilieri	z i l i e r ij
tirajul	t i r a zh u l
simbolic	s i m b o l i k
între	a@ n t r e
două	d o w @
exemplare	e g z e m p l a r e
zilnic	z i l n i k
principal	p r i n ch i p a l
reaudiat	r e a u d i a t
semăn	s e m @ n
mamii	m a m i j
tatii	t a t i j
gorjenii	g o r zh e n i j
liniștiți	l i n i sh t i ts ij
evolua	e v o l u a
resursele	r e s u r s e l e
cele	ch e l e
bogate	b o g a t e
restul	r e s t u l
resurselor	r e s u r s e l o r
există	e g z i s t @
ceea	ch e e@ a
putea	p u t e@ a
însemna	a@ n s e m n a
schimbarea	s k i m b a r e@ a
industriei	i n d u s t r i e j
petroliere	p e t r o l i e r e
opinia	o p i n i a
cheia	k e j a
atingere	a t i n dz e r e
rezultatului	r e z u l t a t u l u j
procedurii	p r o ch e d u r i j
spun	s p u n
oficialii	o f i ch i a l i j
comisiei	k o m i s i e j
europene	e u r o p e n e
comunicat	k o m u n i k a t
greu	g r e w
coordonezi	k o o r d o n e z ij
echipă	e k i p @
sunteți	s u n t e ts ij
cuplu	k u p l u
realmente	r e a l m e n t e
impresionant	i m p r e s j o n a n t
întâlnit	a@ n t a@ l n i t
ivești	i v e sh t ij
vrem	v r e m
orice	o r i ch e
preț	p r e ts
victoria	v i k t o r i a
spus	s p u s
peste	p e s t e
locuri	l o k u r ij
frumoase	f r u m o@ a s e
femei	f e m e j
general	dz e n e r a l
lucrează	l u k r e@ a z @
comenzi	k o m e n z ij
vorbești	v o r b e sh t ij
antrenorul	a n t r e n o r u l
ungur	u n g u r
considerat	k o n s i d e r a t
favoriți	f a v o r i ts ij
danezii	d a n e z i j
jucat	zh u k a t
modest	m o d e s t
numai	n u m a j
evoluat	e v o l u a t
dormea	d o r m e@ a
toată	t o@ a t @
noaptea	n o@ a p t e@ a
stat	s t a t
liturghie	l i t u r g i e
personaj	p e r s o n a zh
romantic	r o m a n t i k
sensibil	s e n s i b i l
ofere	o f e r e
traficul	t r a f i k u l
cluj	k l u zh
deranjant	d e r a n zh a n t
numi	n u m i
place	p l a ch e
pare	p a r e
vlad	v l a d
constantinescu	k o n s t a n t i n e s k u
directorul	d i r e k t o r u l
turneului	t u r n e u l u j
sport	s p o r t
arena	a r e n a
dezamăgire	d e z a m @ dz i r e
clar	k l a r
lăcașul	l @ k a sh u l
cult	k u l t
cadrul	k a d r u l
acestui	a ch e s t u j
proiect	p r o j e k t
germanii	dz e r m a n i j
modernizeze	m o d e r n i z e z e
sera	s e r a
liceului	l i ch e w l u j
talent	t a l e n t
totul	t o t u l
deosebit	d e o s e b i t
scena	s ch e n a
revistă	r e v i s t @
fata	f a t a
antrena	a n t r e n a
clubul	k l u b u l
sportiv	s p o r t i v
farul	f a r u l
încă	a@ n k @
legitimată	l e dz i t i m a t @
văzut	v @ z u t
aproape	a p r o@ a p e
modele	m o d e l e
descărca	d e s k @ r k a
deal	d e@ a l
zona	z o n a
podgoria	p o d g o r i a
frumos	f r u m o s
joacă	zh o@ a k @
deschis	d e s k i s
luat	l u a t
soția	s o ts i a
vrut	v r u t
violeze	v j o l e z e
erau	j e r a w
prilej	p r i l e zh
reculegere	r e k u l e dz e r e
aveți	a v e ts ij
dialog	d i a l o g
doamna	d o@ a m n a
ministru	m i n i s t r u
chemat	k e m a t
aștept	a sh t e p t
drag	d r a g
semnat	s e m n a t
valoarea	v a l o@ a r e@ a
ieftin	j e f t i n
gazul	g a z u l
ratat	r a t a t
extrem	e k s t r e m
trezesc	t r e z e s k
niște	n i sh t e
zgomote	z g o m o t e
înainte	a@ n a i n t e
niciodată	n i ch j o d a t @
prețul	p r e ts u l
nicio	n i ch j o
formă	f o r m @
vreun	v r e@ u n
sens	s e n s
atunci	a t u n ch ij
vedeam	v e d e@ a m
geam	dz e@ a m
mesaj	m e s a zh
visez	v i s e z
lucruri	l u k r u r ij
nici	n i ch ij
îngrijesc	a@ n g r i zh e s k
bolnavi	b o l n a v ij
spiritele	s p i r i t e l e
degenerat	d e dz e n e r a t
fiind	f i i n d
nevoie	n e v o j e
intervenția	i n t e r v e n ts i a
ordine	o r d i n e
urmăriți	u r m @ r i ts ij
imagini	i m a dz i n ij
tineri	t i n e r ij
ipostaze	i p o s t a z e
fiecare	f i e k a r e
vedem	v e d e m
vegetație	v e dz e t a ts i e
copiii	k o p i i
petrecut	p e t r e k u t
seară	s e@ a r @
mini	m i n ij
golf	g o l f
bombă	b o m b @
ceas	ch e@ a s
suceveni	s u ch e v e n ij
început	a@ n ch e p u t
raziile	r a z i j l e
vitamina	v i t a m i n a
cinci	ch i n ch ij
influențează	i n f l u e n ts e@ a z @
metabolismul	m e t a b o l i s m u l
glucidelor	g l u ch i d e l o r
lipidelor	l i p i d e l o r
schimbau	s k i m b a w
tacâmurile	t a k a@ m u r i l e
sămi	s @ m ij
despăgubiri	d e s p @ g u b i r ij
nopțile	n o p ts i l e
albe	a l b e
articolul	a r t i k o l u l
actualiza	a k t w a l i z a
parcursul	p a r k u r s u l
zilei	z i l e j
jurul	zh u r u l
orei	o r e j
punct	p u n k t
medicii	m e d i ch i j
finaliza	f i n a l i z a
necropsia	n e k r o p s i a
cadavrului	k a d a v r u l u j
stabili	s t a b i l ij
exactitate	e g z a k t i t a t e
cauza	k a u z a
decesului	d e ch e s u l u j
talciocul	t a l ch j o k u l
împărțit	a@ m p @ r ts i t
patru	p a t r u
sfat	s f a t
întâlnire	a@ n t a@ l n i r e
conspirativă	k o n s p i r a t i v @
trebui	t r e b u i
eliminat	e l i m i n a t
arbitraj	a r b i t r a zh
tipare	t i p a r e
internet	i n t e r n e t
ajustez	a zh u s t e z
mine	m i n e
comenzile	k o m e n z i l e
roate	r o@ a t e
acum	a k u m
stare	s t a r e
asediu	a s e d i w
aliații	a l i a ts i j
totuși	t o t u sh ij
ziua	z i w a
norocoasă	n o r o k o@ a s @
spună	s p u n @
durerea	d u r e r e@ a
trecut	t r e k u t
folosind	f o l o s i n d
butoanele	b u t o@ a n e l e
stânga	s t a@ n g a
probabil	p r o b a b i l
eram	j e r a m
genul	dz e n u l
moldova	m o l d o v a
guvern	g u v e r n
funcțional	f u n k ts j o n a l
cultura	k u l t u r a
spart	s p a r t
echipa	e k i p a
cerc	ch e r k
scăpăm	s k @ p @ m
vezi	v e z ij
concursul	k o n k u r s u l
avut	a v u t
mari	m a r ij
probleme	p r o b l e m e
lemne	l e m n e
pompier	p o m p i e r
audit	a u d i t
analiză	a n a l i z @
financiară	f i n a n ch i a r @
retrăit	r e t r @ i t
blestemat	b l e s t e m a t
spectacolele	s p e k t a k o l e l e
susținute	s u s ts i n u t e
aceștia	a ch e sh t i a
zguduit	z g u d u i t
scenele	s ch e n e l e
premiu	p r e m i w
virtute	v i r t u t e
prea	p r e@ a
desuet	d e s u e t
ridicat	r i d i k a t
înceteze	a@ n ch e t e z e
facem	f a ch e m
plăcere	p l @ ch e r e
încremenit	a@ n k r e m e n i t
când	k a@ n d
auzit	a u z i t
violat	v j o l a t
singura	s i n g u r a
concluzie	k o n k l u z i e
poate	p o@ a t e
trage	t r a dz e
urma	u r m a
dezbaterilor	d e z b a t e r i l o r
existat	e g z i s t a t
conflict	k o n f l i k t
încredere	a@ n k r e d e r e
sacrificiu	s a k r i f i ch i w
eroic	e r o j k
garsonierele	g a r s o n i e r e l e
închiriază	a@ n k i r i a z @
sută	s u t @
euro	e u r o
rezultat	r e z u l t a t
excelent	e k s ch e l e n t
indiferent	i n d i f e r e n t
numele	n u m e l e
adversarului	a d v e r s a r u l u j
adevărul	a d e v @ r u l
colaborarea	k o l a b o r a r e@ a
project	p r o dz e k t
categorie	k a t e g o r i e
bani	b a n ij
accesează	a k ch e s e@ a z @
scriind	s k r i i n d
strigând	s t r i g a@ n d
fost	f o s t
uneori	u n e o r ij
naiv	n a i v
spunea	s p u n e@ a
rânjet	r a@ n zh e t
superior	s u p e r j o r
prințesele	p r i n ts e s e l e
maniere	m a n i e r e
servitoare	s e r v i t o@ a r e
admire	a d m i r e
câini	k a@ j n ij
scoate	s k o@ a t e
buzunar	b u z u n a r
oamenii	o@ a m e n i j
primi	p r i m i
salariile	s a l a r i j l e
jignit	zh i g n i t
zile	z i l e
continuu	k o n t i n u w
copii	k o p i j
prind	p r i n d
gustul	g u s t u l
voluntariatului	v o l u n t a r i a t u l u j
prin	p r i n
contactul	k o n t a k t u l
biserica	b i s e r i k a
internațional	i n t e r n a ts j o n a l
vedea	v e d e@ a
spuneam	s p u n e@ a m
mereu	m e r e w
direct	d i r e k t
voiam	v o j a m
managerul	m a n a dz e r u l
voia	v o j a
diplomat	d i p l o m a t
cheie	k e j e
specială	s p e ch i a l @
total	t o t a l
partea	p a r t e@ a
celor	ch e l o r
dezvolta	d e z v o l t a
infrastructura	i n f r a s t r u k t u r a
sportivă	s p o r t i v @
putem	p u t e m
titlul	t i t l u l
musulmanii	m u s u l m a n i j
beau	b e@ a u
multă	m u l t @
sunat	s u n a t
telefoanele	t e l e f o@ a n e l e
curte	k u r t e
povestește	p o v e s t e sh t e
gică	dz i k @
copos	k o p o s
mâinile	m a@ j n i l e
zicu	z i k u
amintesc	a m i n t e s k
mare	m a r e
jocurile	zh o k u r i l e
implicat	i m p l i k a t
scandaluri	s k a n d a l u r ij
automat	a u t o m a t
toții	t o ts i j
beneficiarii	b e n e f i ch i a r i j
unor	u n o r
burse	b u r s e
pierd	p i e r d
mulțumit	m u l ts u m i t
normal	n o r m a l
condus	k o n d u s
idee	i d e e
bună	b u n @
suporteri	s u p o r t e r ij
afișat	a f i sh a t
banner	b a n n e r
mesajul	m e s a zh u l
vinde	v i n d e
steaua	s t e@ a w a
dreptul	d r e p t u l
geamului	dz e@ a m u l u j
studioului	s t u d i o u l u j
emisiunea	e m i s i u n e@ a
toți	t o ts ij
clienți	k l i e n ts ij
fideli	f i d e l ij
legii	l e dz i j
femeia	f e m e j a
suferea	s u f e r e@ a
pneumonie	p n e w m o n i e
agravat	a g r a v a t
starea	s t a r e@ a
sănătate	s @ n @ t a t e
natural	n a t u r a l
rezultatele	r e z u l t a t e l e
diferă	d i f e r @
merge	m e r dz e
tribunalul	t r i b u n a l u l
lozan	l o z a n
totodată	t o t o d a t @
indisponibilizat	i n d i s p o n i b i l i z a t
autoturisme	a u t o t u r i s m e
precum	p r e k u m
importante	i m p o r t a n t e
ordinul	o r d i n u l
lucrez	l u k r e z
firmă	f i r m @
telecomunicații	t e l e k o m u n i k a ts i j
creez	k r e e z
haine	h a i n e
pictez	p i k t e z
această	a ch e@ a s t @
rigiditate	r i dz i d i t a t e
bucureștiului	b u k u r e sh t j u l u j
școala	sh k o@ a l a
veche	v e k e
acesta	a ch e s t a
trecuse	t r e k u s e
legal	l e g a l
frontiera	f r o n t i e r a
giurgiu	dz i u r dz i w
testul	t e s t u l
presupunere	p r e s u p u n e r e
scrierea	s k r i e r e@ a
stilou	s t i l o w
electronic	e l e k t r o n i k
plătiți	p l @ t i ts ij
cardul	k a r d u l
făcut	f @ k u t
praf	p r a f
becali	b e k a l i
polițiștii	p o l i ts i sh t i ij
probe	p r o b e
aseară	a s e@ a r @
locul	l o k u l
incidentului	i n ch i d e n t u l u j
scurt	s k u r t
întâmplă	a@ n t a@ m p l @
exact	e g z a k t
ieșirea	j e sh i r e@ a
recesiune	r e ch e s i u n e
estimată	e s t i m a t @
anterior	a n t e r j o r
primul	p r i m u l
trimestru	t r i m e s t r u
lansat	l a n s a t
mitul	m i t u l
holocaustului	h o l o k a w s t u l u j
elevii	e l e v i j
reducere	r e d u ch e r e
procent	p r o ch e n t
șiau	sh j a w
manifestat	m a n i f e s t a t
nemulțumirea	n e m u l ts u m i r e@ a
deci	d e ch ij
vorbi	v o r b i
erori	e r o r ij
tactice	t a k t i ch e
stareț	s t a r e ts
grasa	g r a s a
adjunct	a d zh u n k t
încasările	a@ n k a s @ r i l e
persoanele	p e r s o@ a n e l e
juridice	zh u r i d i ch e
nivelul	n i v e l u l
anul	a n u l
cedat	ch e d a t
înapoi	a@ n a p o j
sper	s p e r
viitor	v i j t o r
mansardele	m a n s a r d e l e
construite	k o n s t r u i t e
bloc	b l o k
strada	s t r a d a
regina	r e dz i n a
maria	m a r i a
râmnicu	r a@ m n i k u
vâlcea	v a@ l ch e@ a
vocea	v o ch e@ a
cristalină	k r i s t a l i n @
curată	k u r a t @
provocare	p r o v o k a r e
gazdele	g a z d e l e
resping	r e s p i n g
balonul	b a l o n u l
trimis	t r i m i s
careul	k a r e w l
măsuri	m @ s u r ij
împotriva	a@ m p o t r i v a
huliganilor	h u l i g a n i l o r
implicați	i m p l i k a ts ij
incidente	i n ch i d e n t e
autorităților	a u t o r i t @ ts i l o r
locale	l o k a l e
înregistrat	a@ n r e dz i s t r a t
pagube	p a g u b e
materiale	m a t e r i a l e
răspuns	r @ s p u n s
amar	a m a r
tehnicianul	t e h n i ch i a n u l
gorjenilor	g o r zh e n i l o r
prost	p r o s t
fotbaliștii	f o t b a l i sh t i j
patrulea	p a t r u l e@ a
suspect	s u s p e k t
nicolae	n i k o l a e
lucrarea	l u k r a r e@ a
elaborată	e l a b o r a t @
prof	p r o f
aveam	a v e@ a m
vreo	v r e@ o
revoluție	r e v o l u ts i e
lipsa	l i p s a
tact	t a k t
parlamentul	p a r l a m e n t u l
guvernul	g u v e r n u l
vecinii	v e ch i n i j
amabil	a m a b i l
saluta	s a l u t a
tipuri	t i p u r ij
fapte	f a p t e
situația	s i t u a ts i a
prezintă	p r e z i n t @
astfel	a s t f e l
discurs	d i s k u r s
italia	i t a l i a
jucătorii	zh u k @ t o r i j
posibilitatea	p o s i b i l i t a t e@ a
joace	zh o@ a ch e
nivel	n i v e l
motivez	m o t i v e z
vorbesc	v o r b e s k
oricum	o r i k u m
undeva	u n d e v a
preajma	p r e@ a zh m a
mici	m i ch ij
ceva	ch e v a
gigantul	dz i g a n t u l
lumii	l u m i j
costat	k o s t a t
miliarde	m i l i a r d e
dolari	d o l a r ij
condiții	k o n d i ts i j
florin	f l o r i n
aducerea	a d u ch e r e@ a
imobilului	i m o b i l u l u j
vechea	v e k e@ a
cheltui	k e l t u i
edililor	e d i l i l o r
virgulă	v i r g u l @
milioane	m i l j o a n e
centru	ch e n t r u
comercial	k o m e r ch i a l
plus	p l u s
galeria	g a l e r i a
treizeci	t r e j z e ch ij
auzi	a u z i
cântând	k a@ n t a@ n d
onest	o n e s t
spune	s p u n e
năduf	n @ d u f
ancuța	a n k u ts a
liderii	l i d e r i j
mutat	m u t a t
slab	s l a b
aleasă	a l e@ a s @
roman	r o m a n
atacatorii	a t a k a t o r i j
fugit	f u dz i t
autoturism	a u t o t u r i s m
numere	n u m e r e
înmatriculare	a@ n m a t r i k u l a r e
polonia	p o l o n i a
proiectele	p r o j e k t e l e
termen	t e r m e n
lung	l u n g
familia	f a m i l i a
simte	s i m t e
pagubele	p a g u b e l e
evaluate	e v a l w a t e
aproximativ	a p r o k s i m a t i v
polii	p o l i ij
treabă	t r e@ a b @
ține	ts i n e
exclusiv	e k s k l u s i v
antrenor	a n t r e n o r
vagabond	v a g a b o n d
golan	g o l a n
rând	r a@ n d
ștefan	sh t e f a n
rugby	r u g b i
dorm	d o r m
apuc	a p u k
mustul	m u s t u l
sora	s o r a
soacra	s o@ a k r a
nepoata	n e p o@ a t a
știu	sh t i u
glumit	g l u m i t
percepția	p e r ch e p ts i a
descifrat	d e s ch i f r a t
unii	u n i j
jucători	zh u k @ t o r ij
tragere	t r a dz e r e
inimă	i n i m @
moment	m o m e n t
încolo	a@ n k o l o
cutume	k u t u m e
scrie	s k r i e
haiku	h a j k u
elev	e l e v
școlar	sh k o l a r
coandă	k o@ a n d @
treilea	t r e j l e@ a
suntem	s u n t e m
făcuți	f @ k u ts ij
arbitri	a r b i t r ij
medicul	m e d i k u l
zice	z i ch e
combinat	k o m b i n a t
crezi	k r e z ij
produse	p r o d u s e
beneficia	b e n e f i ch i a
handicap	h a n d i k a p
grav	g r a v
studenta	s t u d e n t a
iale	j a l e
ucisă	u ch i s @
strangulare	s t r a n g u l a r e
revedere	r e v e d e r e
băieți	b @ j e ts ij
astăzi	a s t @ z ij
muncitori	m u n ch i t o r ij
lopeți	l o p e ts ij
riscă	r i s k @
grei	g r e j
închisoare	a@ n k i s o@ a r e
marcam	m a r k a m
pierdeam	p i e r d e@ a m
iași	j a sh ij
sumă	s u m @
costa	k o s t a
enorm	e n o r m
lilieci	l i l i e ch ij
constatat	k o n s t a t a t
picioare	p i ch j o@ a r e
minte	m i n t e
sigur	s i g u r
țările	ts @ r i l e
arhitectul	a r h i t e k t u l
rezervat	r e z e r v a t
neau	n e@ a w
pozitiv	p o z i t i v
zilele	z i l e l e
reveni	r e v e n ij
episodul	e p i s o d u l
cârtița	k a@ r t i ts a
clanul	k l a n u l
interlopilor	i n t e r l o p i l o r
suspecții	s u s p e k ts i j
sustras	s u s t r a s
scule	s k u l e
electrice	e l e k t r i ch e
componente	k o m p o n e n t e
electronice	e l e k t r o n i ch e
eroul	e r o w l
gazdelor	g a z d e l o r
dacian	d a ch i a n
varga	v a r g a
strigă	s t r i g @
aceia	a ch e j a
percepi	p e r ch e p ij
scandalurile	s k a n d a l u r i l e
singurul	s i n g u r u l
teatru	t e@ a t r u
pereți	p e r e ts ij
tractor	t r a k t o r
prima	p r i m a
dată	d a t @
urcând	u r k a@ n d
ușor	u sh o r
bulevardul	b u l e v a r d u l
deocamdată	d e@ o k a m d a t @
reformarea	r e f o r m a r e@ a
luptei	l u p t e j
droguri	d r o g u r ij
moise	m o j s e
patroni	p a t r o n ij
afaceri	a f a ch e r ij
cartier	k a r t i e r
sceptici	s ch e p t i ch ij
legătură	l e g @ t u r @
viabilitatea	v i a b i l i t a t e@ a
noii	n o j i
monezi	m o n e z ij
dorea	d o r e@ a
salariu	s a l a r i w
minim	m i n i m
egal	e g a l
coaliția	k o a l i ts i a
testa	t e s t a
mașini	m a sh i n ij
tunelurile	t u n e l u r i l e
parlamentului	p a r l a m e n t u l u j
percepție	p e r ch e p ts i e
auto	a u t o
flatantă	f l a t a n t @
zdreanță	z d r e@ a n ts @
unul	u n u l
zglobii	z g l o b i j
căței	k @ ts e j
faci	f a ch ij
poți	p o ts ij
fără	f @ r @
goblenurile	g o b l e n u r i l e
mele	m e l e
autoportret	a u t o p o r t r e t
rembrandt	r e m b r a n d t
miau	m i a u
trebuit	t r e b u i t
scandat	s k a n d a t
muncim	m u n ch i m
cerșim	ch e r sh i m
aventură	a v e n t u r @
primit	p r i m i t
goluri	g o l u r ij
club	k l u b
suma	s u m a
pretutindeni	p r e t u t i n d e n ij
clujeni	k l u zh e n ij
cinei	ch i n e j
septembrie	s e p t e m b r i e
elaborăm	e l a b o r @ m
aplicare	a p l i k a r e
legi	l e dz ij
luase	l u a s e
cavou	k a v o w
loviți	l o v i ts ij
sportivi	s p o r t i v ij
clubului	k l u b u l u j
nostru	n o s t r u
nevinovați	n e v i n o v a ts ij
palat	p a l a t
pionierilor	p j o n i e r i l o r
picta	p i k t a
experților	e k s p e r ts i l o r
conturile	k o n t u r i l e
false	f a l s e
folosite	f o l o s i t e
marketing	m a r k e t i n g
promovarea	p r o m o v a r e@ a
întotdeauna	a@ n t o t d e@ a u n a
tehnic	t e h n i k
următorul	u r m @ t o r u l
pasaj	p a s a zh
lista	l i s t a
renovărilor	r e n o v @ r i l o r
pasajul	p a s a zh u l
lujerului	l u zh e r u l u j
cresc	k r e s k
bulibașei	b u l i b a sh e j
noua	n o w a
formulă	f o r m u l @
iubesc	j u b e s k
muzica	m u z i k a
adversar	a d v e r s a r
accesibil	a k ch e s i b i l
recidivist	r e ch i d i v i s t
arestat	a r e s t a t
preventiv	p r e v e n t i v
furt	f u r t
locuințe	l o k u i n ts e
vinovat	v i n o v a t
traseul	t r a s e w l
trece	t r e ch e
băiat	b @ j a t
alei	a l e j
piste	p i s t e
biciclete	b i ch i k l e t e
jogging	zh o g dz i n g
propriul	p r o p r i w l
adina	a d i n a
acord	a k o r d
solicitarea	s o l i ch i t a r e@ a
juca	zh u k a
marți	m a r ts ij
psiholog	p s i h o l o g
iulius	j u l j u s
datoria	d a t o r i a
sprijini	s p r i zh i n i
mijloacele	m i zh l o@ a ch e l e
dispoziție	d i s p o z i ts i e
spitalul	s p i t a l u l
urmează	u r m e@ a z @
recupereze	r e k u p e r e z e
banii	b a n i j
psihiatru	p s i h i a t r u
chiajna	k i a zh n a
venim	v e n i m
fața	f a ts a
publicului	p u b l i k u l u j
marian	m a r i a n
șaisprezece	sh a j s p r e z e ch e
proiectul	p r o j e k t u l
exploziv	e k s p l o z i v
antrenant	a n t r e n a n t
haios	h a j o s
posibil	p o s i b i l
optimile	o p t i m i l e
competiției	k o m p e t i ts i e j
consider	k o n s i d e r
coregraf	k o r e g r a f
contemporan	k o n t e m p o r a n
presei	p r e s e j
americane	a m e r i k a n e
anchetatorii	a n k e t a t o r i j
concentrat	k o n ch e n t r a t
atentat	a t e n t a t
parter	p a r t e r
biblioteca	b i b l j o t e k a
etaj	e t a zh
birourile	b i r o u r i l e
exemplu	e g z e m p l u
hepatita	h e p a t i t a
boală	b o@ a l @
transmitere	t r a n s m i t e r e
sexuală	s e k s w a l @
lumea	l u m e@ a
interesată	i n t e r e s a t @
realizată	r e@ a l i z a t @
patronul	p a t r o n u l
jignea	zh i g n e@ a
presă	p r e s @
explic	e k s p l i k
întâmplat	a@ n t a@ m p l a t
ales	a l e s
afacere	a f a ch e r e
sală	s a l @
fitness	f i t n e s s
ideea	i d e e@ a
energia	e n e r dz i a
până	p a@ n @
gherghina	g e r g i n a
recompensă	r e k o m p e n s @
vagoanele	v a g o@ a n e l e
reparate	r e p a r a t e
fier	f i e r
vechi	v e k i
confirmat	k o n f i r m a t
acestea	a ch e s t e@ a
sondaj	s o n d a zh
recent	r e ch e n t
china	k i n a
tânără	t a@ n @ r @
demonstrat	d e m o n s t r a t
contrariul	k o n t r a r i w l
țări	ts @ r ij
africane	a f r i k a n e
asiatice	a s i a t i ch e
america	a m e r i k a
zonele	z o n e l e
frecventate	f r e k v e n t a t e
prostituate	p r o s t i t w a t e
poliția	p o l i ts i a
comunitară	k o m u n i t a r @
importantă	i m p o r t a n t @
calificarea	k a l i f i k a r e@ a
productiv	p r o d u k t i v
sistemul	s i s t e m u l
credite	k r e d i t e
familii	f a m i l i j
evacuate	e v a k w a t e
aștepta	a sh t e p t a
rezervele	r e z e r v e l e
jocul	zh o k u l
cafeaua	k a f e@ a w a
dependent	d e p e n d e n t
pepsi	p e p s ij
protestelor	p r o t e s t e l o r
judecat	zh u d e k a t
treime	t r e i m e
cazuri	k a z u r ij
urgente	u r dz e n t e
prețurile	p r e ts u r i l e
hainele	h a i n e l e
adresez	a d r e s e z
mulțumiri	m u l ts u m i r ij
familiei	f a m i l i e j
fetiței	f e t i ts e j
gest	dz e s t
nemulțumiți	n e m u l ts u m i ts ij
ateliere	a t e l i e r e
motiv	m o t i v
aleg	a l e g
magazinele	m a g a z i n e l e
pantofi	p a n t o f ij
depune	d e p u n e
urile	u r i l e
alcătuiesc	a l k @ t u j e s k
grup	g r u p
compact	k o m p a k t
apără	a p @ r @
golul	g o l u l
onoare	o n o@ a r e
antrenez	a n t r e n e z
condițiile	k o n d i ts i j l e
reușit	r e u sh i t
siguranță	s i g u r a n ts @
elevi	e l e v ij
scriu	s k r i w
poezie	p o e z i e
igienic	i dz i e n i k
bogați	b o g a ts ij
ionuț	j o n u ts
postulache	p o s t u l a k e
campionii	k a m p j o n i j
locali	l o k a l ij
vopseaua	v o p s e@ a w a
deoarece	d e o@ a r e ch e
negru	n e g r u
perlat	p e r l a t
afara	a f a r a
terenului	t e r e n u l u j
momentul	m o m e n t u l
începem	a@ n ch e p e m
dezbaterea	d e z b a t e r e@ a
ulterior	u l t e r i o r
conducătorul	k o n d u k @ t o r u l
gabriel	g a b r i e l
post	p o s t
andrei	a n d r e j
adolescent	a d o l e s ch e n t
dinamic	d i n a m i k
super	s u p e r
valoros	v a l o r o s
mergi	m e r dz ij
film	f i l m
faptele	f a p t e l e
hunedorenii	h u n e d o r e n i j
roxana	r o k s a n a
siluetă	s i l u e t @
invidiat	i n v i d i a t
deciziile	d e ch i z i j l e
altora	a l t o r a
atacând	a t a k a@ n d
terenul	t e r e n u l
dreptei	d r e p t e j
tradiționale	t r a d i ts j o n a l e
acte	a k t e
sabotaj	s a b o t a zh
cetatea	ch e t a t e@ a
râșnov	r a@ sh n o v
colecție	k o l e k ts i e
capcane	k a p k a n e
nimic	n i m i k
etnicii	e t n i ch i j
nemți	n e m ts ij
pregătesc	p r e g @ t e s k
decada	d e k a d a
culturii	k u l t u r i j
germane	dz e r m a n e
tineretului	t i n e r e t u l u j
șapte	sh a p t e
buget	b u dz e t
aceea	a ch e e@ a
poezia	p o e z i a
aiud	a j u d
benefic	b e n e f i k
creației	k r e@ a ts i e j
artistice	a r t i s t i ch e
jucătorul	zh u k @ t o r u l
oprit	o p r i t
malul	m a l u l
timișului	t i m i sh u l u j
graiul	g r a j u l
turcesc	t u r ch e s k
șoferul	sh o f e r u l
explică	e k s p l i k @
temut	t e m u t
miam	m j a m
închiriat	a@ n k i r i a t
apartament	a p a r t a m e n t
cameră	k a m e r @
coleg	k o l e g
asemenea	a s e m e n e@ a
arbitrez	a r b i t r e z
concursurile	k o n k u r s u r i l e
naționale	n a ts j o n a l e
țară	ts a r @
dans	d a n s
ministrului	m i n i s t r u l u j
interne	i n t e r n e
nica	n i k a
dotarea	d o t a r e@ a
camere	k a m e r e
presupune	p r e s u p u n e
costuri	k o s t u r ij
suplimentare	s u p l i m e n t a r e
înseamnă	a@ n s e@ a m n @
focul	f o k u l
anunțat	a n u n ts a t
consideră	k o n s i d e r @
suflet	s u f l e t
arbitrul	a r b i t r u l
inventat	i n v e n t a t
compuneri	k o m p u n e r ij
susține	s u s ts i n e
echipaj	e k i p a zh
sectorului	s e k t o r u l u j
obișnuită	o b i sh n u i t @
rigoarea	r i g o@ a r e@ a
urmat	u r m a t
alte	a l t e
colaborări	k o l a b o r @ r ij
vizelor	v i z e l o r
deschisă	d e s k i s @
români	r o m a@ n ij
ieftine	j e f t i n e
împânzit	a@ m p a@ n z i t
orașul	o r a sh u l
denisa	d e n i s a
pasionată	p a s j o n a t @
jurnalism	zh u r n a l i s m
cristiano	k r i s t i a n o
vorbit	v o r b i t
deplasat	d e p l a s a t
stupul	s t u p u l
viespi	v i e s p ij
autospecială	a u t o s p e ch i a l @
ardere	a r d e r e
distrus	d i s t r u s
asociația	a s o ch i a ts i a
sute	s u t e
cincizeci	ch i n ch i z e ch ij
membrii	m e m b r i j
vândut	v a@ n d u t
gata	g a t a
larg	l a r g
parteneriat	p a r t e n e r i a t
invitat	i n v i t a t
salechard	s a l e k h a r d
comentez	k o m e n t e z
asta	a s t a
momentan	m o m e n t a n
pauză	p a w z @
revenit	r e v e n i t
marele	m a r e l e
abia	a b j a
gară	g a r @
prins	p r i n s
începutul	a@ n ch e p u t u l
lucrat	l u k r a t
norvegienii	n o r v e dz i e n i j
bazele	b a z e l e
ghinion	g i n i o n
fantastic	f a n t a s t i k
minciuna	m i n ch i u n a
formele	f o r m e l e
față	f a ts @
băscuță	b @ s k u ts @
douăzeci	d o w @ z e ch ij
superbe	s u p e r b e
speologia	s p e@ o l o dz i a
dragoste	d r a g o s t e
angela	a n dz e l a
alocuri	a l o k u r ij
exagerat	e k s a dz e r a t
angajat	a n g a zh a t
aveau	a v e@ a u
dezvoltare	d e z v o l t a r e
iată	j a t @
guvernat	g u v e r n a t
comuniștii	k o m u n i sh t i j
secund	s e k u n d
națională	n a ts j o n a l @
griji	g r i zh ij
aleksandru	a l e k s a n d r u
rupt	r u p t
coate	k o@ a t e
spate	s p a t e
visul	v i s u l
devin	d e v i n
politician	p o l i t i ch i a n
hidrogenul	h i d r o dz e n u l
produce	p r o d u ch e
energie	e n e r dz i e
motrică	m o t r i k @
masă	m a s @
fugă	f u g @
destul	d e s t u l
dificil	d i f i ch i l
noastră	n o@ a s t r @
respectată	r e s p e k t a t @
cristea	k r i s t e@ a
arabi	a r a b ij
țara	ts a r a
alocat	a l o k a t
denumirea	d e n u m i r e@ a
copil	k o p i l
sănătos	s @ n @ t o s
relativ	r e l a t i v
frecvent	f r e k v e n t
oxigen	o k s i dz e n
temperaturi	t e m p e r a t u r ij
buturugi	b u t u r u dz ij
gust	g u s t
mama	m a m a
contribuabili	k o n t r i b w a b i l ij
achitat	a k i t a t
impozitele	i m p o z i t e l e
alta	a l t a
bărbații	b @ r b a ts i ij
putut	p u t u t
ocazie	o k a z i e
identificat	i d e n t i f i k a t
rămas	r @ m a s
alege	a l e dz e
obiect	o b i e k t
austriac	a u s t r i a k
niciun	n i ch j u n
fotbalist	f o t b a l i s t
român	r o m a@ n
vreodată	v r e@ o d a t @
condamnare	k o n d a m n a r e
solicitări	s o l i ch i t @ r ij
garantare	g a r a n t a r e
apartamente	a p a r t a m e n t e
plăcut	p l @ k u t
magiunul	m a dz j u n u l
vremuri	v r e m u r ij
plăcute	p l @ k u t e
drumul	d r u m u l
blocat	b l o k a t
ambele	a m b e l e
sensuri	s e n s u r ij
convins	k o n v i n s
participă	p a r t i ch i p @
efectiv	e f e k t i v
directorilor	d i r e k t o r i l o r
furate	f u r a t e
puncte	p u n k t e
deplasare	d e p l a s a r e
detalii	d e t a l i j
mâine	m a@ j n e
bunicii	b u n i ch i j
somn	s o m n
vine	v i n e
căutată	k @ u t a t @
pastrama	p a s t r a m a
oaie	o@ a j e
testat	t e s t a t
alcooltest	a l k o o l t e s t
rezultatul	r e z u l t a t u l
negativ	n e g a t i v
distrat	d i s t r a t
brașovenii	b r a sh o v e n i j
video	v i d e@ o
căsnicie	k @ s n i ch i e
crescut	k r e s k u t
semnul	s e m n u l
artei	a r t e j
calitate	k a l i t a t e
vulgar	v u l g a r
derizoriu	d e r i z o r i w
europei	e u r o p e j
amatorii	a m a t o r i j
genului	dz e n u l u j
considere	k o n s i d e r e
culturale	k u l t u r a l e
religia	r e l i dz i a
arta	a r t a
etcetera	e t ch e t e r a
bucureșteanul	b u k u r e sh t e@ a n u l
decât	d e k a@ t
sibianul	s i b i a n u l
ultimul	u l t i m u l
tricoul	t r i k o w l
dinamo	d i n a m o
purta	p u r t a
căpitan	k @ p i t a n
speriat	s p e r i a t
luato	l u a t o
magazin	m a g a z i n
icoane	i k o@ a n e
personaje	p e r s o n a zh e
mizați	m i z a ts ij
noul	n o w l
sezon	s e z o n
parcurs	p a r k u r s
mobilizarea	m o b i l i z a r e@ a
număr	n u m @ r
militari	m i l i t a r ij
afganistan	a f g a n i s t a n
inflamat	i n f l a m a t
tensiunile	t e n s i u n i l e
băieții	b @ j e ts i j
pregătiți	p r e g @ t i ts ij
psihic	p s i h i k
tare	t a r e
agerpres	a dz e r p r e s
exista	e g z i s t a
ascunde	a s k u n d e
trupurile	t r u p u r i l e
victimelor	v i k t i m e l o r
represiunii	r e p r e s i u n i j
geografia	dz e@ o g r a f i a
materia	m a t e r i a
preferată	p r e f e r a t @
școală	sh k o@ a l @
hernie	h e r n i e
paralizat	p a r a l i z a t
stângă	s t a@ n g @
bogdan	b o g d a n
popescu	p o p e s k u
gazde	g a z d e
accidentat	a k ch i d e n t a t
împrumut	a@ m p r u m u t
oricât	o r i k a@ t
umflat	u m f l a t
manuale	m a n w a l e
visat	v i s a t
actori	a k t o r ij
rolurile	r o l u r i l e
japonez	zh a p o n e z
bărbatul	b @ r b a t u l
salvat	s a l v a t
citiți	ch i t i ts ij
vedetele	v e d e t e l e
învingem	a@ n v i n dz e m
impune	i m p u n e
respect	r e s p e k t
adversarilor	a d v e r s a r i l o r
drept	d r e p t
mâncăm	m a@ n k @ m
planul	p l a n u l
export	e k s p o r t
îndeplinit	a@ n d e p l i n i t
integral	i n t e g r a l
calitativ	k a l i t a t i v
studiul	s t u d j u l
geotehnic	dz e@ o t e h n i k
esențial	e s e n ts i a l
alegerea	a l e dz e r e@ a
teren	t e r e n
vehicule	v e h i k u l e
cuprind	k u p r i n d
zone	z o n e
rampă	r a m p @
răspunde	r @ s p u n d e
murit	m u r i t
banal	b a n a l
patul	p a t u l
danseze	d a n s e z e
vals	v a l s
atac	a t a k
brutal	b r u t a l
noroc	n o r o k
indignează	i n d i g n e@ a z @
pricina	p r i ch i n a
prieteni	p r i e t e n ij
buni	b u n ij
admitere	a d m i t e r e
fete	f e t e
lăsat	l @ s a t
handbal	h a n d b a l
ador	a d o r
plimb	p l i m b
decizia	d e ch i z i a
echipe	e k i p e
scump	s k u m p
vinul	v i n u l
majoritatea	m a zh o r i t a t e@ a
învins	a@ n v i n s
flăcările	f l @ k @ r i l e
izbucnit	i z b u k n i t
cuptor	k u p t o r
dezafectat	d e z a f e k t a t
cumva	k u m v a
părți	p @ r ts ij
transmiteți	t r a n s m i t e ts i
locuitorilor	l o k u j t o r i l o r
fabrică	f a b r i k @
copilăria	k o p i l @ r i a
piesele	p i e s e l e
provin	p r o v i n
achizițiile	a k i z i ts i j l e
muzeografilor	m u z e@ o g r a f i l o r
donații	d o n a ts i j
protest	p r o t e s t
procurorii	p r o k u r o r i j
personalul	p e r s o n a l u l
auxiliar	a u k s i l i a r
arhivele	a r h i v e l e
practic	p r a k t i k
blocate	b l o k a t e
saramurii	s a r a m u r i j
cosota	k o s o t a
expresii	e k s p r e s i j
oare	o@ a r e
mera	m e r a
criminal	k r i m i n a l
jafului	zh a f u l u j
vagoane	v a g o@ a n e
sărit	s @ r i t
șină	sh i n @
poporul	p o p o r u l
afgan	a f g a n
dornic	d o r n i k
pace	p a ch e
oricare	o r i k a r e
altul	a l t u l
mediul	m e d i w l
social	s o ch i a l
seama	s e@ a m a
strugurii	s t r u g u r i j
copt	k o p t
alertează	a l e r t e@ a z @
controlorii	k o n t r o l o r i ij
observarea	o p s e r v a r e@ a
aparat	a p a r a t
zbor	z b o r
confiscat	k o n f i s k a t
iranul	i r a n u l
activitățile	a k t i v i t @ ts i l e
gustate	g u s t a t e
participanți	p a r t i ch i p a n ts ij
ieșit	j e sh i t
incredibil	i n k r e d i b i l
local	l o k a l
decide	d e ch i d e
daca	d a k a
taxa	t a k s a
reglementa	r e g l e m e n t a
taiwanului	t a j v a n u l u j
spectacol	s p e k t a k o l
adaptat	a d a p t a t
celebrul	ch e l e b r u l
biblic	b i b l i k
știftu	sh t i f t u
tocmai	t o k m a j
londra	l o n d r a
regia	r e dz i a
ultimii	u l t i m i j
ianuarie	j a n w a r i e
magazinelor	m a g a z i n e l o r
găsește	g @ s e sh t e
spumant	s p u m a n t
umple	u m p l e
paharul	p a h a r u l
treimi	t r e i m ij
discuții	d i s k u ts i j
permite	p e r m i t e
lăsăm	l @ s @ m
pilot	p i l o t
amfiteatrul	a m f i t e@ a t r u l
colegii	k o l e dz i j
adus	a d u s
revista	r e v i s t a
ocaziile	o k a z i i l e
fond	f o n d
ozonul	o z o n u l
proprietăți	p r o p r i e t @ ts ij
oxidante	o k s i d a n t e
puternice	p u t e r n i ch e
sprijin	s p r i zh i n
țărână	ts @ r a@ n @
junior	zh u n j o r
delphin	d e l f i n
bucurești	b u k u r e sh t ij
organizează	o r g a n i z e@ a z @
selecție	s e l e k ts i e
vârsta	v a@ r s t a
șase	sh a s e
treisprezece	t r e j s p r e z e ch e
recunoaște	r e k u n o@ a sh t e
purtătorul	p u r t @ t o r u l
unității	u n i t @ ts i j
spitalicești	s p i t a l i ch e sh t ij
doctor	d o k t o r
cristian	k r i s t i a n
jianu	zh i a n u
puneți	p u n e ts ij
compoziție	k o m p o z i ts i e
jumătate	zh u m @ t a t e
montați	m o n t a ts ij
mijloc	m i zh l o k
fierte	f i e r t e
sosul	s o s u l
muștar	m u sh t a r
preparat	p r e p a r a t
diluat	d i l u a t
oțet	o ts e t
sare	s a r e
piper	p i p e r
ulei	u l e j
măsline	m @ s l i n e
șaptezeci	sh a p t e z e ch ij
bujor	b u zh o r
șansa	sh a n s a
înscrie	a@ n s k r i e
dubla	d u b l a
clasă	k l a s @
dulăpioare	d u l @ p j o a r e
calculatoare	k a l k u l a t o@ a r e
televizoare	t e l e v i z o@ a r e
mașină	m a sh i n @
valoare	v a l o@ a r e
oară	o@ a r @
riscau	r i s k a w
campionat	k a m p j o n a t
eugeniu	e u dz e n j u
rădulescu	r @ d u l e s k u
pavel	p a v e l
întâlnește	a@ n t a@ l n e sh t e
uruguayanul	u r u g w a i a n u l
pablo	p a b l o
varianta	v a r i a n t a
șanse	sh a n s e
congres	k o n g r e s
substanță	s u p s t a n ts @
blochează	b l o k e@ a z @
accesul	a k ch e s u l
sangvin	s a n g v i n
puneam	p u n e@ a m
versurile	v e r s u r i l e
muzică	m u z i k @
afirmă	a f i r m @
filma	f i l m a
marii	m a r i j
negre	n e g r e
delta	d e l t a
dunării	d u n @ r i j
podișul	p o d i sh u l
dobrogei	d o b r o dz e j
viețuiește	v i e ts u j e sh t e
prăfuit	p r @ f u i t
stradă	s t r a d @
ceaușeasca	ch e@ a u sh e@ a s k a
crispată	k r i s p a t @
ilie	i l i e
dosar	d o s a r
știam	sh t i a m
deja	d e zh a
pași	p a sh ij
schiță	s k i ts @
servită	s e r v i t @
ceșcuțe	ch e sh k u ts e
lucrăm	l u k r @ m
săraci	s @ r a ch ij
simt	s i m t
nedreptățiți	n e d r e p t @ ts i ts ij
veljovici	v e l zh o v i ch ij
șaizeci	sh a j z e ch ij
grozav	g r o z a v
verdeș	v e r d e sh
gorbaciov	g o r b a ch j o v
efectuăm	e f e k t u @ m
evaluări	e v a l w @ r ij
bilioane	b i l i o@ a n e
blițuri	b l i ts u r ij
solidă	s o l i d @
algeria	a l dz e r i a
condusă	k o n d u s @
abdelaziz	a b d e l a z i z
bouteflika	b u t e f l i k a
lepră	l e p r @
cultivată	k u l t i v a t @
clădește	k l @ d e sh t e
strică	s t r i k @
alin	a l i n
auzea	a u z e@ a
trăiesc	t r @ j e s k
națiuni	n a ts i u n ij
austria	a u s t r i a
germania	dz e r m a n i a
cehia	ch e h i a
practicați	p r a k t i k a ts ij
exercițiile	e g z e r ch i ts i i l e
kegel	k e g e l
solistă	s o l i s t @
pianista	p i a n i s t a
franceză	f r a n ch e z @
mulțime	m u l ts i m e
kape	k a p e
pasă	p a s @
bănel	b @ n e l
secolul	s e k o l u l
nouăsprezece	n o w @ s p r e z e ch e
patruzeci	p a t r u z e ch ij
stabilește	s t a b i l e sh t e
definitiv	d e f i n i t i v
puerto	p w e r t o
rico	r i k o
așterneți	a sh t e r n e ts ij
hârtie	h a@ r t i e
iubi	j u b i
omul	o m u l
vivu	v i v u
petru	p e t r u
rareș	r a r e sh
insensibili	i n s e n s i b i l ij
misogini	m i s o dz i n ij
nenorociți	n e n o r o ch i ts ij
belgiene	b e l dz i e n e
haifa	h a i f a
covei	k o v e j
expresie	e k s p r e s i e
sistemului	s i s t e m u l u j
ticăloșit	t i k @ l o sh i t
albit	a l b i t
grevei	g r e v e j
magistraților	m a dz i s t r a ts i l o r
apărare	a p @ r a r e
primește	p r i m e sh t e
medvedi	m e d v e d i
rusia	r u s i a
montpellier	m o n t p e l i e r
franța	f r a n ts a
pick	p i k
ungaria	u n g a r i a
salonic	s a l o n i k
grecia	g r e ch i a
lăsase	l @ s a s e
operă	o p e r @
obișnuiau	o b i sh n u j a w
clădirii	k l @ d i r i j
evacuată	e v a k w a t @
reabilitată	r e a b i l i t a t @
strigi	s t r i dz ij
șarpele	sh a r p e l e
începe	a@ n ch e p e
sâsâie	s a@ s a@ j e
amenințând	a m e n i n ts a@ n d
perseverent	p e r s e v e r e n t
metan	m e t a n
mediaș	m e d i a sh
clăbucește	k l @ b u ch e sh t e
gură	g u r @
sperie	s p e r i e
brusc	b r u s k
reuni	r e u n i
cunosc	k u n o s k
râde	r a@ d e
naște	n a sh t e
nouă	n o w @
zvon	z v o n
privea	p r i v e@ a
ceaușescu	ch e@ a u sh e s k u
pofta	p o f t a
același	a ch e l a sh ij
știi	sh t i j
terasă	t e r a s @
bush	b u sh
albania	a l b a n i a
soluție	s o l u ts i e
profunzimi	p r o f u n z i m ij
trăiește	t r @ j e sh t e
branzovenescu	b r a n z o v e n e s k u
antreprenorul	a n t r e p r e n o r u l
ajutat	a zh u t a t
fetele	f e t e l e
sale	s a l e
nicoliță	n i k o l i ts @
ceață	ch e@ a ts @
lombardo	l o m b a r d o
radice	r a d i ch e
limba	l i m b a
italiană	i t a l i a n @
important	i m p o r t a n t
creșterea	k r e sh t e r e@ a
zotta	z o t a
studiem	s t u d i e m
piața	p i a ts a
toma	t o m a
manager	m a n a dz e r
development	d e v e l o p m e n t
răspunsul	r @ s p u n s u l
bancă	b a n k @
belgia	b e l dz i a
naționalizată	n a ts j o n a l i z a t @
nimănui	n i m @ n u j
curând	k u r a@ n d
răbda	r @ b d a
facă	f a k @
concepi	k o n ch e p ij
vacanță	v a k a n ts @
caraibe	k a r a i b e
așadar	a sh a d a r
ultima	u l t i m a
perioadă	p e r i o@ a d @
declinului	d e k l i n u l u j
ireversibil	i r e v e r s i b i l
regimului	r e dz i m u l u j
ceaușist	ch e@ a u sh i s t
zvonul	z v o n u l
înlocuia	a@ n l o k u j a
anecdota	a n e k d o t a
păcat	p @ k a t
vorbă	v o r b @
radu	r a d u
cratimă	k r a t i m @
pârvulescu	p a@ r v u l e s k u
citește	ch i t e sh t e
interviu	i n t e r v i w
frumoasa	f r u m o@ a s a
bistrițeancă	b i s t r i ts e@ a n k @
grevă	g r e v @
fiscală	f i s k a l @
iasă	j a s @
rândurile	r a@ n d u r i l e
sfătuiește	s f @ t u j e sh t e
tanti	t a n t ij
halat	h a l a t
final	f i n a l
adaug	a d a w g
demisec	d e m i s e k
fiarbă	f i a r b @
accidentul	a k ch i d e n t u l
constanța	k o n s t a n ts a
tulcea	t u l ch e@ a
revelația	r e v e l a ts i a
anului	a n u l u j
desemnată	d e s e m n a t @
norvegianca	n o r v e dz i a n k a
karolina	k a r o l i n a
grovdal	g r o v d a l
încep	a@ n ch e p
școlile	sh k o l i l e
levski	l e v s k i
americanul	a m e r i k a n u l
mull	m u l
romanelor	r o m a n e l o r
îndeamnă	a@ n d e@ a m n @
pornește	p o r n e sh t e
părut	p @ r u t
reprezentația	r e p r e z e n t a ts i a
sâmbătă	s a@ m b @ t @
coregrafului	k o r e g r a f u l u ij
jean	zh e@ a n
maillot	m a j l o t
aură	a u r @
tainică	t a j n i k @
înconjoară	a@ n k o n zh o@ a r @
ascendența	a s ch e n d e n ts a
adriean	a d r i e a n
videanu	v i d e@ a n u
conferință	k o n f e r i n ts @
palatul	p a l a t u l
eduard	e d u a r d
iacob	j a k o b
rutieră	r u t i e r @
botoșani	b o t o sh a n ij
dezvoltarea	d e z v o l t a r e@ a
zăcământului	z @ k @ m a@ n t u l u j
reevaluată	r e e v a l w a t @
reduce	r e d u ch e
riscurile	r i s k u r i l e
diminua	d i m i n u a
necesare	n e ch e s a r e
relaxează	r e l a k s e@ a z @
fizice	f i z i ch e
felicitări	f e l i ch i t @ r ij
amestecați	a m e s t e k a ts ij
asezonați	a s e z o n a ts ij
import	i m p o r t
mărit	m @ r i t
crește	k r e sh t e
economiei	e k o n o m i e j
frecventa	f r e k v e n t a
casa	k a s a
cultură	k u l t u r @
câteva	k a@ t e v a
administrează	a d m i n i s t r e@ a z @
firma	f i r m a
softwear	s o f t w e r
aplicații	a p l i k a ts i j
comerț	k o m e r ts
întorsesem	a@ n t o r s e s e m
găman	g @ m a n
dilevski	d i l e v s k i
șoavă	sh o@ a v @
prepeliță	p r e p e l i ts @
externele	e k s t e r n e l e
stănișoară	s t @ n i sh o@ a r @
viața	v i a ts a
personală	p e r s o n a l @
profesională	p r o f e s j o n a l @
aceeași	a ch e e@ a sh ij
amintește	a m i n t e sh t e
dacăi	d a k @ j
sângele	s a@ n dz e l e
domnului	d o m n u l u j
hristos	h r i s t o s
reguli	r e g u l ij
clare	k l a r e
funcționare	f u n k ts j o n a r e
improvizației	i m p r o v i z a ts i e j
președintelui	p r e sh e d i n t e l u j
venezuelean	v e n e z u e l e@ a n
hugo	h u g o
capitalul	k a p i t a l u l
înființare	a@ n f i i n ts a r e
paisprezece	p a j s p r e z e ch e
pământ	p @ m a@ n t
definiție	d e f i n i ts i e
clară	k l a r @
chineze	k i n e z e
îmbunătățesc	a@ m b u n @ t @ ts e s k
cunoștințele	k u n o sh t i n ts e l e
contribuție	k o n t r i b u ts i e
experiența	e k s p e r i e n ts a
imaginația	i m a dz i n a ts i a
sărbătoarea	s @ r b @ t o@ a r e@ a
bairam	b a j r a m
binecuvântată	b i n e k u v a@ n t a t @
puține	p u ts i n e
trebuie	t r e b u j e
activ	a k t i v
daniel	d a n i e l
perioada	p e r i o@ a d a
anilor	a n i l o r
nouăzeci	n o w @ z e ch ij
stilul	s t i l u l
viena	v i e n a
lipsită	l i p s i t @
întradevăr	a@ n t r a d e v @ r
iuliu	j u l j u
maniu	m a n i u
sezoane	s e z o@ a n e
adversarii	a d v e r s a r i j
campioni	k a m p j o n ij
păcurar	p @ k u r a r
murgan	m u r g a n
distribuția	d i s t r i b u ts i a
piesei	p i e s e j
eric	e r i k
guerin	g w e r i n
francis	f r a n ch i s
leplay	l e p l e j
eugen	e u dz e n
neață	n e@ a ts @
nota	n o t a
seamănă	s e@ a m @ n @
doberman	d o b e r m a n
obez	o b e z
făceam	f @ ch e@ a m
ciorbă	ch j o r b @
tochitură	t o k i t u r @
marius	m a r j u s
duhovnicul	d u h o v n i k u l
căutat	k @ u t a t
clipă	k l i p @
întăresc	a@ n t @ r e s k
uite	u j t e
deschid	d e s k i d
scurtă	s k u r t @
paranteză	p a r a n t e z @
străină	s t r @ i n @
înșelato	a@ n sh e l a t o
româncă	r o m a@ n k @
cazul	k a z u l
ultimelor	u l t i m e l o r
întâlniri	a@ n t a@ l n i r ij
mihail	m i h a i l
oarecare	o@ a r e k a r e
îmbunătățire	a@ m b u n @ t @ ts i r e
creștere	k r e sh t e r e
fondul	f o n d u l
populație	p o p u l a ts i e
ieși	j e sh i
pensie	p e n s i e
puiu	p u j u
flore	f l o r e
căciuliță	k @ ch j u l i ts @
comandantul	k o m a n d a n t u l
miliției	m i l i ts i e j
vulcan	v u l k a n
comănoiu	k o m @ n o j u
ancheta	a n k e t a
așteptăm	a sh t e p t @ m
ivan	i v a n
februarie	f e b r w a r i e
refereau	r e f e r e@ a u
marijuana	m a r i h w a n a
încercați	a@ n ch e r k a ts ij
amintiți	a m i n t i ts ij
președintele	p r e sh e d i n t e l e
tribuna	t r i b u n a
adunării	a d u n @ r i j
public	p u b l i k
gesturi	dz e s t u r ij
sociale	s o ch i a l e
campanii	k a m p a n i j
umanitare	u m a n i t a r e
vitejie	v i t e zh i e
problemă	p r o b l e m @
ești	j e sh t ij
pițipoancă	p i ts i p o@ a n k @
popa	p o p a
soare	s o@ a r e
amiaza	a m i a z a
straton	s t r a t o n
ignatov	i g n a t o v
tinerii	t i n e r i j
domnii	d o m n i j
reșița	r e sh i ts a
găsesc	g @ s e s k
adaugă	a d a w g @
ouăle	o w @ l e
făină	f @ i n @
obțină	o p ts i n @
curgă	k u r g @
subiectele	s u b i e k t e l e
mitologice	m i t o l o dz i ch e
senzualitate	s e n z w a l i t a t e
accentuată	a k ch e n t w a t @
gheorghe	g e o@ r g e
începând	a@ n ch e p a@ n d
pățit	p @ ts i t
fosta	f o s t a
arhitectă	a r h i t e k t @
șefă	sh e f @
câștigat	k a@ sh t i g a t
procesul	p r o ch e s u l
intentat	i n t e n t a t
primăriei	p r i m @ r i e j
primarul	p r i m a r u l
anchetă	a n k e t @
plecat	p l e k a t
doua	d o w a
variantă	v a r i a n t @
schimbare	s k i m b a r e
producă	p r o d u k @
plenară	p l e n a r @
partidului	p a r t i d u l u j
ghici	g i ch i
ghicitoarea	g i ch i t o@ a r e@ a
călcat	k @ l k a t
singurătate	s i n g u r @ t a t e
însuflețit	a@ n s u f l e ts i t
duhul	d u h u l
sfânt	s f a@ n t
iubirii	j u b i r i j
săsărman	s @ s @ r m a n
gospodărește	g o s p o d @ r e sh t e
situez	s i t u e z
experiență	e k s p e r i e n ts @
binevenită	b i n e v e n i t @
astă	a s t @
piștă	p i sh t @
optsprezece	o p t s p r e z e ch e
univ	u n i v
oferi	o f e r i
simplilor	s i m p l i l o r
spectatori	s p e k t a t o r ij
politice	p o l i t i ch e
mostră	m o s t r @
ridicol	r i d i k o l
înalt	a@ n a l t
zăbavă	z @ b a v @
plătim	p l @ t i m
rovignetele	r o v i n j e t e l e
degeaba	d e dz e@ a b a
sandruc	s a n d r u k
masur	m a s u r
abed	a b e d
cotroceni	k o t r o ch e n ij
nechermanii	n e k e r m a n i j
alături	a l @ t u r ij
mona	m o n a
pivniceru	p i v n i ch e r u
traian	t r a j a n
băsescu	b @ s e s k u
monica	m o n i k a
macovei	m a k o v e j
întrebat	a@ n t r e b a t
năuci	n @ u ch ij
greșiseră	g r e sh i s e r @
completă	k o m p l e t @
știți	sh t i ts ij
altă	a l t @
catastrofă	k a t a s t r o f @
diferența	d i f e r e n ts a
tabelă	t a b e l @
favoarea	f a v o@ a r e@ a
sperăm	s p e r @ m
iarnă	j a r n @
ușoară	u sh o@ a r @
imaginat	i m a dz i n a t
bineînțeles	b i n e a@ n ts e l e s
scenarii	s ch e n a r i j
puse	p u s e
îndoielii	a@ n d o j e l i j
contrazise	k o n t r a z i s e
mitroi	m i t r o j
pătrană	p @ t r a n @
ailaltă	a j l a l t @
mântuială	m a@ n t u j a l @
boil	b o j l
excepție	e k s ch e p ts i e
homosexualilor	h o m o s e k s w a l i l o r
timișoreni	t i m i sh o r e n ij
libertății	l i b e r t @ ts i j
închis	a@ n k i s
autoritățile	a u t o r i t @ ts i l e
fulham	f u l h a m
ideal	i d e@ a l
interzis	i n t e r z i s
yoga	j o g a
furtună	f u r t u n @
hramul	h r a m u l
zicândui	z i k a@ n d u j
sfântul	s f a@ n t u l
lazăr	l a z @ r
buzăul	b u z @ u l
primele	p r i m e l e
județe	zh u d e ts e
concretizează	k o n k r e t i z e@ a z @
cercetarea	ch e r ch e t a r e@ a
uimitor	u j m i t o r
presiune	p r e s i u n e
seceră	s e ch e r @
ascult	a s k u l t
vând	v a@ n d
opel	o p e l
rekord	r e k o r d
întâmplător	a@ n t a@ m p l @ t o r
adevărat	a d e v @ r a t
umplem	u m p l e m
pivnițele	p i v n i ts e l e
cămările	k @ m @ r i l e
doilea	d o j l e@ a
asupra	a s u p r a
unei	u n e j
clinici	k l i n i ch ij
dezintoxicare	d e z i n t o k s i k a r e
ciudad	ch j u d a d
juarez	h w a r e z
lună	l u n @
difuzat	d i f u z a t
fetița	f e t i ts a
parfum	p a r f u m
tuberoze	t u b e r o z e
remarca	r e m a r k a
arunc	a r u n k
boabele	b o@ a b e l e
crăpate	k r @ p a t e
păstrez	p @ s t r e z
sănătoase	s @ n @ t o@ a s e
bianca	b i a n k a
vrea	v r e@ a
prietenă	p r i e t e n @
ioana	i o@ a n a
bașii	b a sh i j
răsuna	r @ s u n a
polus	p o l u s
mixată	m i k s a t @
rigler	r i g l e r
ființă	f i i n ts @
michael	m j k a @ l
soliști	s o l i sh t ij
principali	p r i n ch i p a l ij
notorietate	n o t o r i e t a t e
tovărășești	t o v @ r @ sh e sh t ij
șaptesprezece	sh a p t e s p r e z e ch e
plângeri	p l a@ n dz e r ij
penale	p e n a l e
dolj	d o l zh
supraviețuitor	s u p r a v i e ts u i t o r
cvasi	k v a s ij
pustietate	p u s t i e t a t e
paralizată	p a r a l i z a t @
decontează	d e k o n t e@ a z @
tranzacțiile	t r a n z a k ts i j l e
acțiunile	a k ts i u n i l e
grupului	g r u p u l u j
merit	m e r i t
evoluțiile	e v o l u ts i j l e
acestor	a ch e s t o r
rada	r a d a
nebun	n e b u n
vasluiul	v a s l u j u l
brazilia	b r a z i l i a
considerată	k o n s i d e r a t @
responsabilă	r e s p o n s a b i l @
violențe	v j o l e n ts e
izbucnite	i z b u k n i t e
întoarcerii	a@ n t o@ a r ch e r i j
zelaya	z e l a j a
salvă	s a l v @
simțit	s i m ts i t
lovitură	l o v i t u r @
pumn	p u m n
coaste	k o@ a s t e
blană	b l a n @
căciuli	k @ ch i u l ij
continuă	k o n t i n w @
supărat	s u p @ r a t
george	dz e o@ r dz e
românește	r o m a@ n e sh t e
rușine	r u sh i n e
malaezia	m a l a e z i a
homosexualitatea	h o m o s e k s w a l i t a t e@ a
folosită	f o l o s i t @
politică	p o l i t i k @
almășan	a l m @ sh a n
csoma	ch j o m a
măgurean	m @ g u r e@ a n
gigi	dz i dz i
privește	p r i v e sh t e
succesorul	s u k ch e s o r u l
funcția	f u n k ts i a
secretar	s e k r e t a r
despărțeau	d e s p @ r ts e@ a u
mâțe	m a@ ts e
vânzare	v a@ n z a r e
spectacolului	s p e k t a k o l u l u j
grecesc	g r e ch e s k
apărea	a p @ r e@ a
vadă	v a d @
redegist	r e d e dz i s t
mulțumiți	m u l ts u m i ts ij
fericiți	f e r i ch i ts ij
obama	o b a m a
americii	a m e r i ch i j
afirmat	a f i r m a t
semi	s e m ij
central	ch e n t r a l
doisprezece	d o j s p r e z e ch e
santiago	s a n t i a g o
ventuea	v e n t u e a
spania	s p a n i a
comună	k o m u n @
maghiari	m a g i a r ij
elena	e l e n a
precupețele	p r e k u p e ts e l e
voie	v o j e
vândă	v a@ n d @
colț	k o l ts
amândoi	a m a@ n d o j
poftă	p o f t @
formidabilă	f o r m i d a b i l @
intuiție	i n t u i ts i e
telefilmoteca	t e l e f i l m o t e k a
ghiozdan	g j o z d a n
groaznică	g r o@ a z n i k @
hagi	h a dz i
nemulțumit	n e m u l ts u m i t
eșecurile	e sh e k u r i l e
eșecuri	e sh e k u r ij
însuși	a@ n s u sh ij
folcloric	f o l k l o r i k
academia	a k a d e m i a
poliție	p o l i ts i e
mâna	m a@ n a
sfert	s f e r t
bergman	b e r g m a n
căsătorit	k @ s @ t o r i t
situație	s i t u a ts i e
apoptoza	a p o p t o z a
moarte	m o@ a r t e
celulară	ch e l u l a r @
programată	p r o g r a m a t @
câteodată	k a@ t e@ o d a t @
adevărate	a d e v @ r a t e
catedrale	k a t e d r a l e
joia	zh o j a
restaura	r e s t a u r a
având	a v a@ n d
potențial	p o t e n ts i a l
turistic	t u r i s t i k
găsi	g @ s i
slujba	s l u zh b a
dorită	d o r i t @
tomșani	t o m sh a n ij
județul	zh u d e ts u l
prahova	p r a h o v a
suferă	s u f e r @
puși	p u sh ij
tratament	t r a t a m e n t
coafuri	k o@ a f u r ij
animată	a n i m a t @
dansatori	d a n s a t o r ij
inițiativă	i n i ts i a t i v @
similară	s i m i l a r @
sponsorizată	s p o n s o r i z a t @
merlot	m e r l o t
neagră	n e@ a g r @
cabernet	k a b e r n e t
regală	r e g a l @
sortimente	s o r t i m e n t e
vinuri	v i n u r ij
degustate	d e g u s t a t e
plătesc	p l @ t e s k
angajații	a n g a zh a ts i j
dezbrac	d e z b r a k
rostit	r o s t i t
cehă	ch e h @
înțelegători	a@ n ts e l e g @ t o r i
lebăda	l e b @ d a
vest	v e s t
prezent	p r e z e n t
soțul	s o ts u l
maximilian	m a k s i m i l i a n
adunat	a d u n a t
trupă	t r u p @
predă	p r e d @
miliardar	m i l i a r d a r
sară	s a r @
infectă	i n f e k t @
ziarul	z i a r u l
numărul	n u m @ r u l
regret	r e g r e t
nemira	n e m i r a
șuteu	sh u t e w
tibi	t i b i
suspecți	s u s p e k ts ij
sediul	s e d i w l
audieri	a u d i e r ij
reședință	r e sh e d i n ts @
deschiderea	d e s k i d e r e@ a
serii	s e r i j
întreținută	a@ n t r e ts i n u t @
line	l i n e
lagarce	l a g a r ch e
tradus	t r a d u s
lucrări	l u k r @ r ij
tinerețe	t i n e r e ts e
ambasador	a m b a s a d o r
american	a m e r i k a n
rădăcini	r @ d @ ch i n ij
românești	r o m a@ n e sh t ij
unghiuri	u n g j u r ij
decapitați	d e k a p i t a ts ij
stăpân	s t @ p a@ n
toamnă	t o@ a m n @
demonstranții	d e m o n s t r a n ts i j
confruntau	k o n f r u n t a w
violent	v j o l e n t
forțele	f o r ts e l e
informează	i n f o r m e@ a z @
bătuți	b @ t u ts ij
arestați	a r e s t a ts ij
noapte	n o@ a p t e
încălcat	a@ n k @ l k a t
legea	l e dz e@ a
plăti	p l @ t i
învingător	a@ n v i n g @ t o r
degrabă	d e g r a b @
înfrânt	a@ n f r a@ n t
atât	a t a@ t
concluziile	k o n k l u z i j l e
analizei	a n a l i z e j
spunem	s p u n e m
predictivă	p r e d i k t i v @
române	r o m a@ n e
secțiunea	s e k ts i u n e@ a
persoane	p e r s o@ a n e
cărucior	k @ r u ch j o r
găzduit	g @ z d u i t
clădire	k l @ d i r e
fostei	f o s t e j
garnizoane	g a r n i z o@ a n e
oraș	o r a sh
bolnav	b o l n a v
natură	n a t u r @
grijă	g r i zh @
proaspăt	p r o@ a s p @ t
cumpărată	k u m p @ r a t @
trăim	t r @ i m
sărăcie	s @ r @ ch i e
intelectuală	i n t e l e k t w a l @
goanei	g o@ a n e j
materialiste	m a t e r i a l i s t e
plăcea	p l @ ch e@ a
pocher	p o k e r
percep	p e r ch e p
situației	s i t u a ts i e j
mihaela	m i h a e l a
așezam	a sh a z a m
lângă	l a@ n g @
canapea	k a n a p e@ a
simtă	s i m t @
vecin	v e ch i n
reacționat	r e a k ts j o n a t
atrași	a t r a sh ij
fonduri	f o n d u r ij
povara	p o v a r a
sionko	s i o n k o
naibii	n a j b i j
președinte	p r e sh e d i n t e
încadrarea	a@ n k a d r a r e@ a
credibilitate	k r e d i b i l i t a t e
delațiunea	d e l a ts i u n e@ a
ziariștii	z i a r i sh t i j
vânduți	v a@ n d u ts ij
magistrații	m a dz i s t r a ts i j
curții	k u r ts i j
apel	a p e l
activitatea	a k t i v i t a t e@ a
celelalte	ch e l e l a l t e
muta	m u t a
spre	s p r e
amiază	a m i a z @
poată	p o@ a t @
șurubaru	sh u r u b a r u
supracazări	s u p r a k a z @ r ij
noștri	n o sh t r ij
cămin	k @ m i n
interesează	i n t e r e s e@ a z @
împrejurimile	a@ m p r e zh u r i m i l e
frumusețe	f r u m u s e ts e
dorim	d o r i m
grădină	g r @ d i n @
dumneavoastră	d u m n e@ a v o@ a s t r @
cules	k u l e s
porumb	p o r u m b
zagreb	z a g r e b
recorduri	r e k o r d u r ij
ediția	e d i ts i a
neuitat	n e u j t a t
fasole	f a s o l e
ciolan	ch j o l a n
permanență	p e r m a n e n ts @
asistați	a s i s t a ts ij
câinele	k a@ j n e l e
costel	k o s t e l
simplă	s i m p l @
greșeală	g r e sh e@ a l @
foto	f o t o
singur	s i n g u r
pitea	p i t e@ a
mașinist	m a sh i n i s t
cumpăr	k u m p @ r
lucrările	l u k r @ r i l e
iubește	j u b e sh t e
cinstiți	ch i n s t i ts ij
cântăm	k a@ n t @ m
scenariu	s ch e n a r i w
portofoliu	p o r t o f o l i w
predoiu	p r e d o j u
justiției	zh u s t i ts i e j
împlinit	a@ m p l i n i t
reparau	r e p a r a w
exportăm	e k s p o r t @ m
fierb	f i e r b
minute	m i n u t e
lasă	l a s @
acoperit	a k o p e r i t
regretă	r e g r e t @
orgoliul	o r g o l i w l
rațiunea	r a ts i u n e@ a
conchis	k o n k i s
uriașă	u r i a sh @
spumă	s p u m @
abundență	a b u n d e n ts @
analizăm	a n a l i z @ m
iuda	j u d a
lovește	l o v e sh t e
dispărut	d i s p @ r u t
lungă	l u n g @
luptă	l u p t @
boala	b o@ a l a
sezonului	s e z o n u l u j
mirică	m i r i k @
mafia	m a f i a
trăgând	t r @ g a@ n d
cateterul	k a t e t e r u l
extrage	e k s t r a dz e
cheagul	k e@ a g u l
învață	a@ n v a ts @
bostan	b o s t a n
saizescu	s a j z e s k u
mergem	m e r dz e m
jucăm	zh u k @ m
taxele	t a k s e l e
plătite	p l @ t i t e
pierdut	p i e r d u t
hățișul	h @ ts i sh u l
corupției	k o r u p ts i e j
premierul	p r e m i e r u l
britanic	b r i t a n i k
gordon	g o r d o n
sprijină	s p r i zh i n @
putere	p u t e r e
funcționarii	f u n k ts j o n a r i j
marca	m a r k a
europeană	e u r o p e@ a n @
mobilității	m o b i l i t @ ts i j
pită	p i t @
țărănească	ts @ r @ n e@ a s k @
gustoasă	g u s t o@ a s @
densă	d e n s @
coaptă	k o@ a p t @
varză	v a r z @
arheologii	a r h e@ o l o dz i j
zonă	z o n @
rand	r a n d
amintirile	a m i n t i r i l e
copilărie	k o p i l @ r i e
aventuroasă	a v e n t u r o@ a s @
întrun	a@ n t r u n
inedit	i n e d i t
parc	p a r k
distracții	d i s t r a k ts i j
șantierul	sh a n t i e r u l
nonstop	n o n s t o p
învăța	a@ n v @ ts a
știe	sh t i e
citească	ch i t e@ a s k @
zgomot	z g o m o t
agitație	a dz i t a ts i e
pumnangii	p u m n a n g i j
gura	g u r a
adică	a d i k @
aduna	a d u n a
explicația	e k s p l i k a ts i a
deloc	d e l o k
găsit	g @ s i t
propriu	p r o p r i w
oboseală	o b o s e@ a l @
socială	s o ch i a l @
snobism	s n o b i s m
rudele	r u d e l e
împușcatului	a@ m p u sh k a t u l u j
uitam	u j t a m
zâmbea	z a@ m b e@ a
mârșav	m a@ r sh a v
vorbească	v o r b e@ a s k @
diabetul	d i a b e t u l
măcina	m @ ch i n a
provoca	p r o v o k a
anumite	a n u m i t e
manifestări	m a n i f e s t @ r ij
îngrijorătoare	a@ n g r i zh o r @ t o@ a r e
chivu	k i v u
poliției	p o l i ts i e j
județului	zh u d e ts u l u j
brăila	b r @ i l a
maneta	m a n e t a
doctoriță	d o k t o r i ts @
mătreață	m @ t r e@ a ts @
fugi	f u dz ij
scări	s k @ r ij
săți	s @ ts ij
asumi	a s u m ij
răspunderea	r @ s p u n d e r e@ a
sfida	s f i d a
constituția	k o n s t i t u ts i a
ingeniozitatea	i n dz e n j o z i t a t e@ a
imediat	i m e d i a t
cuvântul	k u v a@ n t u l
vântul	v a@ n t u l
bătut	b @ t u t
lega	l e g a
marea	m a r e@ a
caspică	k a s p i k @
tranzitând	t r a n z i t a@ n d
turcia	t u r ch i a
dependența	d e p e n d e n ts a
apoi	a p o j
efectua	e f e k t w a
tiruri	t i r u r ij
rachete	r a k e t e
zelzal	z e l z a l
tondar	t o n d a r
fateh	f a t e h
rază	r a z @
confruntări	k o n f r u n t @ r ij
interimar	i n t e r i m a r
hondurasului	h o n d u r a s u l u j
honduras	h o n d u r a s
către	k @ t r e
reprezentanții	r e p r e z e n t a n ts i j
ambasadei	a m b a s a d e j
braziliene	b r a z i l i e n e
desrobiți	d e s r o b i ts ij
jugul	zh u g u l
roșu	r o sh u
bolșevismului	b o l sh e v i s m u l u j
frații	f r a ts i j
cotropiți	k o t r o p i ts ij
pregătirea	p r e g @ t i r e@ a
mașinuțe	m a sh i n u ts e
necesită	n e ch e s i t @
investiție	i n v e s t i ts i e
alți	a l ts ij
surescitați	s u r e s ch i t a ts ij
experiențele	e k s p e r i e n ts e l e
neplăcute	n e p l @ k u t e
ignorate	i g n o r a t e
stricăciuni	s t r i k @ ch j u n ij
completează	k o m p l e t e@ a z @
obliga	o b l i g a
învețe	a@ n v e ts e
gândească	g a@ n d e@ a s k @
bage	b a dz e
dânsul	d a@ n s u l
alternativă	a l t e r n a t i v @
bulibășeli	b u l i b @ sh e l ij
nunți	n u n ts ij
botezuri	b o t e z u r ij
tăieri	t @ j e r ij
împărații	a@ m p @ r a ts i j
președinții	p r e sh e d i n ts i j
stabor	s t a b o r
schimbării	s k i m b @ r i j
părerile	p @ r e r i l e
difereau	d i f e r e@ a w
blecher	b l e k e r
cărțulia	k @ r ts u l i a
pierdută	p i e r d u t @
neagra	n e@ a g r a
veșnicie	v e sh n i ch i e
tânăra	t a@ n @ r a
ciobănesc	ch j o b @ n e s k
bocit	b o ch i t
întreagă	a@ n t r e@ a g @
soiurile	s o j u r i l e
noastre	n o@ a s t r e
nobile	n o b i l e
crâmpoșie	k r a@ m p o sh i e
bătaia	b @ t a j a
soarelui	s o@ a r e l u j
marginea	m a r dz i n e@ a
drumului	d r u m u l u j
izbucnirea	i z b u k n i r e@ a
războiului	r @ z b o j u l u j
civil	ch i v i l
pleacă	p l e@ a k @
zenobia	z e n o b i a
cuba	k u b a
statele	s t a t e l e
spărgătorul	s p @ r g @ t o r u l
încearcă	a@ n ch e@ a r k @
deschidă	d e s k i d @
încuietoarea	a@ n k u j e t o@ a r e@ a
audă	a u d @
angajările	a n g a zh @ r i l e
stomatologi	s t o m a t o l o dz ij
eșuat	e sh w a t
urmașul	u r m a sh u l
șobolanului	sh o b o l a n u l u j
roșiatec	r o sh i a t e k
veșnic	v e sh n i k
năstrușnic	n @ s t r u sh n i k
dușman	d u sh m a n
deranjăm	d e r a n zh @ m
sfâșie	s f a@ sh i e
ușurel	u sh u r e l
scos	s k o s
dințișor	d i n ts i sh o r
răzvrătit	r @ z v r @ t i t
vrășmașilor	v r @ sh m a sh i l o r
devenit	d e v e n i t
numeroase	n u m e r o@ a s e
bătăi	b @ t @ i
întâmpinat	a@ n t a@ m p i n a t
pâine	p a@ j n e
tâmple	t a@ m p l e
văzul	v @ z u l
șoarecele	sh o@ a r e ch e l e
mâncat	m a@ n k a t
hrana	h r a n a
dulău	d u l @ u
traversând	t r a v e r s a@ n d
vârful	v a@ r f u l
vorbeam	v o r b e@ a m
șoaptă	sh o@ a p t @
azvârlit	a z v a@ r l i t
spital	s p i t a l
săptămână	s @ p t @ m a@ n @
coborât	k o b o r a@ t
vâslind	v a@ s l i n d
șerpuit	sh e r p u i t
șerpaș	sh e r p a sh
țăranii	ts @ r a n i j
cultivă	k u l t i v @
grâu	g r a@ w
câștigânduși	k a@ sh t i g a@ n d u sh ij
pâinea	p a@ j n e@ a
tunși	t u n sh ij
mârâiau	m a@ r a@ j a w
păpușă	p @ p u sh @
lână	l a@ n @
mănușă	m @ n u sh @
abandonând	a b a n d o n a@ n d
sfătuit	s f @ t u i t
cineva	ch i n e v a
plâns	p l a@ n s
înduioșat	a@ n d u j o sh a t
povestea	p o v e s t e@ a
înmulțit	a@ n m u l ts i t
câștigul	k a@ sh t i g u l
obținând	o p ts i n a@ n d
dobânda	d o b a@ n d a
întețit	a@ n t e ts i t
reluânduși	r e l u a@ n d u sh ij
vuietul	v u j e t u l
sfâșietor	s f a@ sh i e t o r
printre	p r i n t r e
urâți	u r a@ ts i
veștejiți	v e sh t e zh i ts ij
bâtlan	b a@ t l a n
schimbători	s k i m b @ t o r ij
bucăți	b u k @ ts ij
salcâm	s a l k a@ m
găsite	g @ s i t e
șanț	sh a n ts
trăgeam	t r @ dz e@ a m
săgeata	s @ dz e@ a t a
baloți	b a l o ts ij
tușeau	t u sh e@ a w
belșug	b e l sh u g
simțind	s i m ts i n d
decepția	d e ch e p ts i a
copleșea	k o p l e sh e@ a
adânc	a d a@ n k
pomii	p o m i j
smulși	s m u l sh ij
vecinătăți	v e ch i n @ t @ ts ij
consimțit	k o n s i m ts i t
împărțirea	a@ m p @ r ts i r e@ a
desăvârșit	d e s @ v a@ r sh i t
cântecul	k a@ n t e k u l
externă	e k s t e r n @
împachetat	a@ m p a k e t a t
valiză	v a l i z @
aventurează	a v e n t u r e@ a z @
forță	f o r ts @
tărâmul	t @ r a@ m u l
depistat	d e p i s t a t
actualizând	a k t w a l i z a@ n d
bilanțul	b i l a n ts u l
avuți	a v u ts ij
văzând	v @ z a@ n d
răspândit	r @ s p a@ n d i t
zvonuri	z v o n u r ij
corupți	k o r u p ts ij
strânsă	s t r a@ n s @
dârză	d a@ r z @
maimuțoiul	m a j m u ts o j u l
rățoiul	r @ ts o j u l
șchiop	sh k j o p
atârnat	a t a@ r n a t
creangă	k r e@ a n g @
hoțul	h o ts u l
arșiță	a r sh i ts @
asmuțit	a s m u ts i t
odată	o d a t @
chema	k e m a
rusul	r u s u l
acela	a ch e l a
trezise	t r e z i s e
oaste	o@ a s t e
slujind	s l u zh i n d
soroace	s o r o@ a ch e
rândul	r a@ n d u l
bătrân	b @ t r a@ n
maimarii	m a j m a r i j
văzândul	v @ z a@ n d u l
ostaș	o s t a sh
slobozit	s l o b o z i t
ducă	d u k @
undea	u n d e@ a
dândui	d a@ n d u j
carboave	k a r b o@ a v e
cheltuială	k e l t u j a l @
mulțumi	m u l ts u m i
luânduși	l u a@ n d u sh ij
tovarășii	t o v a r @ sh i j
trase	t r a s e
câteo	k a@ t e@ o
dușcă	d u sh k @
rachiu	r a k i w
mergea	m e r dz e@ a
șovăind	sh o v @ i n d
margine	m a r dz i n e
duce	d u ch e
înaintea	a@ n a i n t e@ a
întâmplare	a@ n t a@ m p l a r e
cărare	k @ r a r e
lăuntrică	l @ u n t r i k @
dumnezeu	d u m n e z e w
petre	p e t r e
vorbind	v o r b i n d
auzind	a u z i n d
uită	u j t @
vede	v e d e
mătăhăind	m @ t @ h @ i n d
părțile	p @ r ts i l e
zise	z i s e
grăbim	g r @ b i m
ostașul	o s t a sh u l
cela	ch e l a
harțag	h a r ts a g
găsim	g @ s i m
beleaua	b e l e@ a w a
chelfăneală	k e l f @ n e@ a l @
drumețul	d r u m e ts u l
cântă	k a@ n t @
temi	t e m ij
vezil	v e z i l
sufletul	s u f l e t u l
cercare	ch e r k a r e
făte	f @ t e
cerșetor	ch e r sh e t o r
capătul	k a p @ t u l
celălalt	ch e l @ l a l t
amândouă	a m a@ n d o w @
carboavele	k a r b o@ a v e l e
pomană	p o m a n @
bietul	b i e t u l
aminte	a m i n t e
câte	k a@ t e
țiam	ts j a m
moștenească	m o sh t e n e@ a s k @
împărăția	a@ m p @ r @ ts i a
cerurilor	ch e r u r i l o r
pune	p u n e
capăt	k a p @ t
iară	j a r @
cere	ch e r e
podului	p o d u l u j
zicând	z i k a@ n d
raiul	r a j u l
navă	n a v @
cânta	k a@ n t a
mirare	m i r a r e
meargă	m e@ a r g @
nerăsplătit	n e r @ s p l @ t i t
purtare	p u r t a r e
cole	k o l e
careo	k a r e@ o
ducea	d u ch e@ a
calea	k a l e@ a
ivane	i v a n e
cânți	k a@ n ts ij
tencurci	t e n k u r ch ij
mulțumesc	m u l ts u m e s k
dvoastră	e@ n m u d a v o@ a s t r @
tresărind	t r e s @ r i n d
cheamă	k e@ a m @
dapoi	d a p o j
răspunse	r @ s p u n s e
zborșit	z b o r sh i t
cerșetorul	ch e r sh e t o r u l
miluit	m i l u i t
săracilor	s @ r a ch i l o r
împrumută	a@ m p r u m u t @
scriptura	s k r i p t u r a
nați	n a ts ij
împrumutul	a@ m p r u m u t u l
căci	k @ ch ij
trebuință	t r e b u i n ts @
dovedesc	d o v e d e s k
oricei	o r i ch e j
darnic	d a r n i k
cuprins	k u p r i n s
fiori	f j o r ij
dezmețit	d e z m e ts i t
căzut	k @ z u t
genunchi	dz e n u n k i
dinaintea	d i n a i n t e@ a
zici	z i ch ij
rogute	r o g u t e
blagosloveștemi	b l a g o s l o v e sh t e m ij
turbinca	t u r b i n k a
întrînsa	a@ n t r a@ n s a
zâmbind	z a@ m b i n d
blagoslovi	b l a g o s l o v i
sătura	s @ t u r a
umblat	u m b l a t
lume	l u m e
slujești	s l u zh e sh t ij
poarta	p o@ a r t a
bucuria	b u k u r i a
deodată	d e@ o d a t @
pica	p i k a
apucă	a p u k @
câmpii	k a@ m p i j
curți	k u r ts ij
deabia	d e@ a b j a
zăreau	z @ r e@ a w
culmea	k u l m e@ a
înserate	a@ n s e r a t e
curțile	k u r ts i l e
intră	i n t r @
ogradă	o g r a d @
înfățișează	a@ n f @ ts i sh e@ a z @
găzduire	g @ z d u i r e
boierul	b o j e r u l
cică	ch i k @
zgârcit	z g a@ r ch i t
împărătesc	a@ m p @ r @ t e s k
nare	n a r e
vrând	v r a@ n d
nevrând	n e v r a@ n d
poruncește	p o r u n ch e sh t e
slugi	s l u dz ij
mâncare	m a@ n k a r e
case	k a s e
nelocuite	n e l o k u i t e
culca	k u l k a
musafirii	m u s a f i r i j
veneau	v e n e@ a u
nitam	n i t a m
nisam	n i s a m
sluga	s l u g a
ascultând	a s k u l t a@ n d
porunca	p o r u n k a
stăpânului	s t @ p a@ n u l u j
gândul	g a@ n d u l
orândui	o r a@ n d u i
cuviință	k u v i i n ts @
draci	d r a ch ij
dracii	d r a ch i j
pereche	p e r e k e
locuia	l o k u j a
necuratul	n e k u r a t u l
porunci	p o r u n ch i
habar	h a b a r
navea	n a v e@ a
odaia	o d a j a
armele	a r m e l e
rânduială	r a@ n d u j a l @
închinat	a@ n k i n a t
obicei	o b i ch e j
tologit	t o l o dz i t
îmbrăcat	a@ m b r @ k a t
divan	d i v a n
moale	m o@ a l e
bumbacul	b u m b a k u l
punânduși	p u n a@ n d u sh ij
așternânduse	a sh t e r n a@ n d u s e
țineau	ts i n e@ a u
picioarele	p i ch j o@ a r e l e
trudit	t r u d i t
odihnească	o d i h n e@ a s k @
stins	s t i n s
lumânarea	l u m a@ n a r e@ a
trezește	t r e z e sh t e
smuncește	s m u n ch e sh t e
perna	p e r n a
aruncă	a r u n k @
sabie	s a b i e
scoală	s k o@ a l @
repede	r e p e d e
aprinde	a p r i n d e
căuta	k @ u t a
casă	k a s @
nimene	n i m e n e
pământul	p @ m a@ n t u l
umblu	u m b l u
bădădăind	b @ d @ d @ i n d
ceor	ch e@ o r
ieste	j e s t e
cruci	k r u ch ij
culcă	k u l k @
ațipească	a ts i p e@ a s k @
glasuri	g l a s u r ij
urâcioase	u r a@ ch j o@ a s e
unele	u n e l e
miorlăiau	m j o r l @ j a w
mâța	m a@ ts a
altele	a l t e l e
covițau	k o v i ts a w
orăcăiau	o r @ k @ j a w
broasca	b r o@ a s k a
mornăiau	m o r n @ j a w
ursul	u r s u l
schimonosite	s k i m o n o s i t e
auzeau	a u z e@ a u
știa	sh t i a
dracului	d r a k u l u j
pricepe	p r i ch e p e
cear	ch e@ a r
stai	s t a j
socoteală	s o k o t e@ a l @
striga	s t r i g a
puternic	p u t e r n i k
pașol	p a sh o l
ciorti	ch j o r t i
diavolii	d i a v o l i ij
cărăbăni	k @ r @ b @ n i
parcăi	p a r k @ j
aducea	a d u ch e@ a
înlăuntru	a@ n l @ u n t r u
ghigosi	g i g o s i
leagă	l e@ a g @
strâns	s t r a@ n s
trântindule	t r a@ n t i n d u s e
ghionturi	g j o n t u r ij
rusești	r u s e sh t ij
inima	i n i m a
capul	k a p u l
dânșii	d a@ n sh i j
nemai	n e m a j
popești	p o p e sh t ij
cântători	k a@ n t @ t o r ij
căpetenia	k @ p e t e n i a
dracilor	d r a ch i l o r
slugile	s l u dz i l e
zăbovesc	z @ b o v e s k
grăbire	g r @ b i r e
știut	sh t i u t
caute	k a u t e
ajungând	a zh u n g a@ n d
vâră	v a@ r @
odaie	o d a j e
șterge	sh t e r dz e
înghesuiește	a@ n g e s u j e sh t e
dimoni	d i m o n ij
încotro	a@ n k o t r o
judec	zh u d e k
acuși	a k u sh ij
necuraților	n e k u r a ts i l o r
incul	i n k u l
tulburat	t u l b u r a t
vați	v a ts ij
mușurluiesc	m u sh u r l u j e s k
râdă	r a@ d @
îmbracă	a@ m b r a k @
înarmează	a@ n a r m e@ a z @
ieșind	j e sh i n d
afară	a f a r @
tărăboi	t @ r @ b o j
sculat	s k u l a t
ograda	o g r a d a
ceai	ch e@ a i
pohonțule	p o h o n ts u l e
teai	t e@ a j
noaptean	n o@ a p t e@ a n
ziseră	z i s e r @
chiori	k j o r ij
orbul	o r b u l
găinilor	g @ i n i l o r
pățesc	p @ ts e s k
dârz	d a@ r z
căptușit	k @ p t u sh i t
gând	g a@ n d
jumulesc	zh u m u l e s k
zgomotul	z g o m o t u l
ista	i s t a
vuiet	v u j e t
odihni	o d i h n i
rusului	r u s u l u j
celuia	ch e l u j a
dracul	d r a k u l
jumulească	zh u m u l e@ a s k @
iertați	j e r t a ts ij
vorbele	v o r b e l e
iaca	j a k a
plină	p l i n @
zbăteau	z b @ t e@ a u
vârșă	v a@ r sh @
gospodin	g o s p o d i n
vânjolit	v a@ n zh o l i t
încaltea	a@ n k a l t e@ a
curățit	k u r @ ts i t
aduc	a d u k
poclon	p o k l o n
dimineață	d i m i n e@ a ts @
aducă	a d u k @
palce	p a l ch e
stroi	s t r o j
trăi	t r @ i
robul	r o b u l
spaima	s p a j m a
bucurie	b u k u r i e
sărindare	s @ r i n d a r e
dăduse	d @ d u s e
popi	p o p ij
izgoni	i z g o n i
fusese	f u s e s e
chip	k i p
veleatul	v e l e@ a t u l
vrei	v r e j
făți	f a@ ts ij
capoi	k a p o j
helbet	h e l b e t
sfârșit	s f a@ r sh i t
pomenește	p o m e n e sh t e
meșteșugul	m e sh t e sh u g u l
vremea	v r e m e@ a
adunase	a d u n a s e
împrejurul	a@ m p r e zh u r u l
satul	s a t u l
șagă	sh a g @
dezleagă	d e z l e@ a g @
tuturor	t u t u r o r
încapă	a@ n k a p @
luând	l u a@ n d
drăcușor	d r @ k u sh o r
cornițe	k o r n i ts e
ardea	a r d e@ a
palcele	p a l ch e l e
crăpa	k r @ p a
pielea	p i e l e@ a
tocmeală	t o k m e@ a l @
veni	v e n i
zilișoare	z i l i sh o@ a r e
zicea	z i ch e@ a
ucigălcrucea	u ch i g @ l k r u ch e@ a
usturime	u s t u r i m e
împușcat	a@ m p u sh k a t
priveau	p r i v e@ a u
leșinau	l e sh i n a w
urmelor	u r m e l o r
barbă	b a r b @
moschicești	m o s k i ch e sh t ij
fuge	f u dz e
poftim	p o f t i m
bucluc	b u k l u k
umbli	u m b l i
jupâne	zh u p a@ n e
înveți	a@ n v e ts ij
altădată	a l t @ d a t @
bântui	b a@ n t u i
sărsăilă	s @ r s @ i l @
spurcat	s p u r k a t
paiul	p a j u l
înzilească	a@ n z i l e@ a s k @
brațe	b r a ts e
sărutândul	s @ r u t a@ n d u l
deacum	d e@ a k u m
rămâi	r @ m a@ j
miai	m j a j
slujesc	s l u zh e s k
împăratul	a@ m p @ r a t u l
încinge	a@ n ch i n dz e
sabia	s a b i a
ranița	r a n i ts a
pușca	p u sh k a
umăr	u m @ r
pornind	p o r n i n d
privitorii	p r i v i t o r i j
căciulile	k @ ch j u l i l e
urau	u r a w
întoarce	a@ n t o@ a r ch e
călătorie	k @ l @ t o r i e
sprâncenată	s p r a@ n ch e n a t @
rămâneai	r @ m a@ n e@ a j
frate	f r a t e
boier	b o j e r
frica	f r i k a
turbincăi	t u r b i n k @ j
păru	p @ r u
carei	k a r e j
făcuse	f @ k u s e
atâta	a t a@ t a
gândea	g a@ n d e@ a
întrebând	a@ n t r e b a@ n d
șede	sh e d e
întreba	a@ n t r e b a
dădeau	d @ d e@ a u
umere	u m e r e
neștiind	n e sh t i i n d
răspundă	r @ s p u n d @
întrebare	a@ n t r e b a r e
ciudată	ch i w d a t @
nicolai	n i k o l a j
scoțând	s k o ts a@ n d
iconiță	i k o n i ts @
sărutândo	s @ r u t a@ n d o
raiului	r a j u l u j
bate	b a t e
poartă	p o@ a r t @
dinlăuntru	d i n l @ u n t r u
tabacioc	t a b a ch j o k
lăutari	l @ u t a r ij
chihăiești	k i h @ j e sh t ij
lucie	l u ch i e
nemailungind	n e m a j l n g i n d
vorba	v o r b a
cotigește	k o t i dz e sh t e
umblă	u m b l @
iadului	j a d u l u j
poftești	p o f t e sh t ij
harașo	h a r a sh o
deschideți	d e s k i d e ts ij
iute	j u t e
tropăind	t r o p @ i n d
frecânduși	f r e k a@ n d u sh ij
gândind	g a@ n d i n d
mușteriu	m u sh t e r i w
neașteptate	n e a sh t e p t a t e
așai	a sh a j
pățito	p @ ts i t o
guleai	g u l e@ a j
alții	a l ts i j
dincotro	d i n k o t r o
tutun	t u t u n
poftea	p o f t e@ a
umblau	u m b l a w
prâsnelul	p r a@ s n e l u l
intrau	i n t r a w
cruce	k r u ch e
vreme	v r e m e
chefăluiește	k e f @ l u j e sh t e
cade	k a d e
chiui	k i u i
horodinca	h o r o d i n k a
cazacinca	k a z a ch i n k a
nepus	n e p u s
vârtejul	v a@ r t e zh u l
răsturna	r @ s t u r n a
tarăbi	t a r @ b ij
venea	v e n e@ a
strici	s t r i ch ij
iznoavele	i z n o@ a v e l e
urnească	u r n e@ a s k @
deacolo	d e@ a k o l o
gândesc	g a@ n d e s k
sucesc	s u ch e s k
frământă	f r @ m a@ n t @
mintea	m i n t e@ a
unuia	u n u j a
talpa	t a l p a
haram	h a r a m
vostru	v o s t r u
păți	p @ ts i
aducețimi	a d u ch e ts i m ij
putină	p u t i n @
piele	p i e l e
câine	k a@ j n e
bețe	b e ts e
jucărie	zh u k @ r i e
mătur	m @ t u r
deaici	d e a i ch ij
tălpoiul	t @ l p o j u l
darabană	d a r a b a n @
furișânduse	f u r i sh a@ n d u s e
iese	j e s e
dânsa	d a@ n s a
război	r @ z b o j
simțire	s i m ts i r e
țuști	ts u sh t ij
tronc	t r o n k
închid	a@ n k i d
zăvoarele	z @ v o@ a r e l e
cornoraților	k o r n o r a ts i l o r
miți	m i ts i
vrodată	v r o d a t @
știre	sh t i r e
porțile	p o r ts i l e
ferecate	f e r e k a t e
lehămetește	l e h @ m e t e sh t e
slujească	s l u zh e@ a s k @
strajă	s t r a zh @
neadormit	n e a d o r m i t
întruna	a@ n t r u n a
moartea	m o@ a r t e@ a
intre	i n t r e
primească	p r i m e@ a s k @
șpaga	sh p a g a
piept	p i e p t
ștoti	sh t o t ij
vidma	v i d m a
duci	d u ch ij
chioară	k j o a r @
stropșește	s t r o p sh e sh t e
neavând	n e@ a v a@ n d
icnește	i k n e sh t e
suspină	s u s p i n @
plângi	p l a@ n dz ij
milă	m i l @
nepăsare	n e p @ s a r e
anină	a n i n @
copac	k o p a k
săturat	s @ t u r a t
crancalâcuri	k r a n k a l a@ k u r ij
sfinte	s f i n t e
dute	d u t e
puterea	p u t e r e@ a
știință	sh t i i n ts @
porunciți	p o r u n ch i ts ij
spunei	s p u n e j
poruncesc	p o r u n ch e s k
moară	m o@ a r @
bătrâni	b @ t r a@ n ij
tine	t i n e
bunătate	b u n @ t a t e
uitânduse	u j t a@ n d u s e
poruncit	p o r u n ch i t
mănânci	m @ n a@ n ch ij
bătrână	b @ t r a@ n @
atingi	a t i n dz ij
înțelesai	a@ n ts e l e s a j
șiți	sh i ts ij
codri	k o d r ij
supărată	s u p @ r a t @
roade	r o@ a d e
copaci	k o p a ch ij
pocneau	p o k n e@ a w
fălcile	f @ l ch i l e
tăiau	t @ j a u
strângea	s t r a@ n dz e@ a
frică	f r i k @
afurisita	a f u r i s i t a
boalele	b o@ a l e l e
suspinând	s u s p i n a@ n d
oftând	o f t a@ n d
ochii	o k i j
stângamprejur	s t a@ n g a m p r e zh u r
punânduse	p u n a@ n d u s e
morții	m o r ts i j
gândeam	g a@ n d e@ a m
berbantlâcuri	b e r b a n t l a@ k u r ij
deale	d e@ a l e
tale	t a l e
dulce	d u l ch e
amară	a m a r @
bato	b a t o
pustia	p u s t i a
bată	b a t @
roase	r o@ a s e
urechile	u r e k i l e
vidmă	v i d m @
bunătățile	b u n @ t @ ts i l e
blestem	b l e s t e m
intru	i n t r u
piere	p i e r e
pofti	p o f t i
taifasuri	t a j f a s u r ij
întreci	a@ n t r e ch ij
șaga	sh a g a
parale	p a r a l e
pastramă	p a s t r a m @
cheful	k e f u l
bunătăți	b u n @ t @ ts ij
bătând	b @ t a@ n d
înfățișază	a@ n f @ ts i sh a z @
supărați	s u p @ r a ts ij
tarei	t a r e j
neastâmpărată	n e a s t a@ m p @ r a t @
avană	a v a n @
spini	s p i n ij
dați	d a ts ij
obraznici	o b r a z n i ch ij
vlăstare	v l @ s t a r e
fragede	f r a dz e d e
răchițică	r @ k i ts i k @
smicele	s m i ch e l e
nuiele	n u j e l e
acestora	a ch e s t o r a
pădurea	p @ d u r e@ a
poznă	p o z n @
auzitai	a u z i t a j
sfințenie	s f i n ts e n i e
înghițind	a@ n g i ts i n d
dumbrăvi	d u m b r @ v ij
lunci	l u n ch ij
huceaguri	h u ch e@ a g u r ij
forfeca	f o r f e k a
pârâiau	p a@ r a@ j a w
măselele	m @ s e l e l e
dureau	d u r e@ a w
șelele	sh e l e l e
grumajii	g r u m a zh i ij
întinzânduse	a@ n t i n z a@ n d u s e
plopii	p l o p i j
plecânduse	p l e k a@ n d u s e
rădăcinile	r @ d @ ch i n i l e
tufari	t u f a r ij
mlădițe	m l @ d i ts e
zămorea	z @ m o r e@ a
sărmana	s @ r m a n a
chinuit	k i n u i t
osândă	o s a@ n d @
mâncaoar	m a@ n k a o@ a r
mănânce	m @ n a@ n ch e
spânzurătoare	s p a@ n z u r @ t o@ a r e
pesemne	p e s e m n e
copiilor	k o p i j l o r
iartă	j a r t @
miar	m i a r
părea	p @ r e@ a
petrea	p e t r e@ a
mergând	m e r g a@ n d
bodrogănind	b o d r o g @ n i n d
vrute	v r u t e
nevrute	n e v r u t e
întunecă	a@ n t u n e k @
chinuiești	k i n u j e sh t ij
dacaș	d a k a sh
țiaș	ts j a sh
teaș	t e@ a sh
frige	f r i dz e
frigare	f r i g a r e
ciudă	ch i u d @
prăpădit	p r @ p @ d i t
adam	a d a m
hoanghină	h o@ a n g i n @
potrivită	p o t r i v i t @
bunișoare	b u n i sh o@ a r e
putrezească	p u t r e z e@ a s k @
ciolanele	ch j o l a n e l e
aude	a u d e
bucată	b u k a t @
necazuri	n e k a z u r ij
direguiești	d i r e g u j e sh t ij
tăcând	t @ k a@ n d
fețe	f e ts e
înădușit	a@ n @ d u sh i t
iatămă	j a t @ m @
opreală	o p r e@ a l @
râsul	r a@ s u l
nenorocita	n e n o r o ch i t a
țiai	ts j a j
trăit	t r @ i t
traiul	t r a j u l
mălaiul	m @ l a j u l
încoace	a@ n k o@ a ch e
blagoslovit	b l a g o s l o v i t
hara	h a r a
para	p a r a
vestea	v e s t e@ a
popă	p o p @
tuns	t u n s
mendrele	m e n d r e l e
toates	t o@ a t e s
fătul	f @ t u l
mori	m o r ij
ceți	ch e ts ij
fiecăruia	f i e k @ r u j a
socoteala	s o k o t e@ a l a
roagă	r o@ a g @
lacrimi	l a k r i m ij
îngăduit	a@ n g @ d u i t
macar	m a k a r
grijesc	g r i zh e s k
racla	r a k l a
slăbănoagă	s l @ b @ n o@ a g @
așez	a sh e z
singurel	s i n g u r e l
funia	f u n i a
slăbi	s l @ b i
cererea	ch e r e r e@ a
luândui	l u a@ n d u j
stăpânire	s t @ p a@ n i r e
vidmei	v i d m e j
rămânând	r @ m a@ n a@ n d
gânduri	g a@ n d u r ij
zbucium	z b u ch j u m
hăis	h @ j s
deatunci	d e@ a t u n ch ij
teleleu	t e l e l e w
tanasă	t a n a s @
pățești	p @ ts e sh t ij
sărăcăciosul	s @ r @ k @ ch j o s u l
fală	f a l @
goală	g o@ a l @
traistă	t r a j s t @
pungă	p u n g @
dorul	d o r u l
pedeapsă	p e d e@ a p s @
nimica	n i m i k a
pământului	p @ m a@ n t u l u j
șmecherie	sh m e k e r i e
fruntea	f r u n t e@ a
rezemată	r e z e m a t @
trăsnește	t r @ s n e sh t e
taci	t a ch ij
meșteșug	m e sh t e sh u g
cumpără	k u m p @ r @
unelte	u n e l t e
teslărie	t e s l @ r i e
lătunoaie	l @ t u n o@ a j e
balamale	b a l a m a l e
piroane	p i r o@ a n e
lăcătoi	l @ k @ t o j
zdravăn	z d r a v @ n
deși	d e sh ij
drăguță	d r @ g u ts @
raclă	r a k l @
ședea	sh e d e@ a
veci	v e ch ij
coți	k o ts ij
atâtai	a t a@ t a j
încheie	a@ n k e j e
scofala	s k o f a l a
sfârși	s f a@ r sh i
așazăte	a sh a z @ t e
așteaptă	a sh t e@ a p t @
răvaș	r @ v a sh
punete	p u n e t e
șadă	sh a d @
mortul	m o r t u l
râlă	r a@ l @
spânzurate	s p a@ n z u r a t e
unai	u n a j
altai	a l t a j
bălălău	b @ l @ l @ w
ăraca	@ r a k a
blestemății	b l e s t e m @ ts i j
arăt	a r @ t
nebunule	n e b u n u l e
umilit	u m i l i t
dăscăli	d @ s k @ l i
întinse	a@ n t i n s e
închiși	a@ n k i sh ij
așezi	a sh e z ij
pierde	p i e r d e
capacul	k a p a k u l
deasupra	d e@ a s u p r a
încuie	a@ n k u j e
lăcata	l @ k a t a
rugămintea	r u g @ m i n t e@ a
umflă	u m f l @
curgătoare	k u r g @ t o@ a r e
conețul	k o n e ts u l
sâmbetei	s a@ m b e t e j
bunica	b u n i k a
groapă	g r o@ a p @
apostolul	a p o s t o l u l
râzând	r a@ z a@ n d
apucat	a p u k a t
sfinției	s f i n ts i e j
binea	b i n e@ a
cinea	ch i n e@ a
suie	s u j e
îndrăzneala	a@ n d r @ z n e@ a l a
năzdrăvăniile	n @ z d r @ v @ n i j l e
desfacă	d e s f a k @
sicriul	s i k r i w l
săși	s @ sh ij
răzbune	r @ z b u n e
visa	v i s a
fațăn	f a ts @ n
niznai	n i z n a j
răbdarea	r @ b d a r e@ a
bunătatea	b u n @ t a t e@ a
margini	m a r dz i n ij
precovârșască	p r e k o v a@ r sh e@ a s k @
fărădelegile	f @ r @ d e l e dz i l e
îndărătnicia	a@ n d @ r @ t n i ch i a
mătrășit	m @ t r @ sh i t
batjocura	b a t zh o k u r a
nuți	n u ts ij
intra	i n t r a
bucuros	b u k u r o s
târâi	t a@ r a@ i
brânci	b r a@ n ch ij
rugândumă	r u g a@ n d u m @
uitat	u j t a t
trăiești	t r @ j e sh t ij
zidul	z i d u l
neamțului	n e@ a m ts u l u j
nesuferită	n e s u f e r i t @
adânci	a d a@ n ch ij
bătrânețe	b @ t r a@ n e ts e
izbeliște	i z b e l i sh t e
trăiască	t r @ j a s k @
moare	m o@ a r e
sine	s i n e
mioi	m j o j
parun	p a r u n
răul	r @ u l
ciuda	ch i u d a
mahorcă	m a h o r k @
chilit	k i l i t
țuică	ts u j k @
holercă	h o l e r k @
parco	p a r k o
mistuia	m i s t u j a
înnebunești	a@ n e b u n e sh t ij
urât	u r a@ t
moarteai	m o@ a r t e@ a j
veacuri	v e@ a k u r ij
trăind	t r @ i n d
contează	k o n t e@ a z @
imobilul	i m o b i l u l
susținerea	s u s ts i n e r e@ a
ambelor	a m b e l o r
partide	p a r t i d e
conducerea	k o n d u ch e r e@ a
noilor	n o i l o r
entități	e n t i t @ ts ij
băimăreanul	b @ j m @ r e@ a n u l
urăște	u r @ sh t e
fățărnicia	f @ ts @ r n i ch i a
prioritate	p r j o r i t a t e
terminali	t e r m i n a l ij
dincolo	d i n k o l o
efectele	e f e k t e l e
economice	e k o n o m i ch e
comerciale	k o m e r ch i a l e
greva	g r e v a
lipsă	l i p s @
justiție	zh u s t i ts i e
reclamă	r e k l a m @
spargerile	s p a r dz e r i l e
ilegale	i l e g a l e
amploarea	a m p l o@ a r e@ a
organizatorii	o r g a n i z a t o r i j
strădui	s t r @ d u i
autentic	a u t e n t i k
poalele	p o@ a l e l e
tâmpei	t a@ m p e j
domeniu	d o m e n j u
sfârșitul	s f a@ r sh i t u l
vieții	v i e ts i j
serioasă	s e r i o@ a s @
micuța	m i k u ts a
căzăturile	k @ z @ t u r i l e
ordinea	o r d i n e@ a
dalmațian	d a l m a ts i a n
conform	k o n f o r m
rezultatelor	r e z u l t a t e l o r
obținute	o p ts i n u t e
consumul	k o n s u m u l
departajarea	d e p a r t a zh a r e@ a
metri	m e t r i
parcurse	p a r k u r s e
secunde	s e k u n d e
amintire	a m i n t i r e
cinste	ch i n s t e
informaticianul	i n f o r m a t i ch i a n u l
sabău	s a b @ w
lăncierilor	l @ n ch i e r i l o r
olanda	o l a n d a
înțeles	a@ n ts e l e s
prindem	p r i n d e m
exmatriculăm	e g z m a t r i k u l @ m
inteligenți	i n t e l i dz e n ts ij
tirinescu	t i r i n e s k u
deține	d e ts i n e
rutiere	r u t i e r e
funcționarea	f u n k ts j o n a r e@ a
optimă	o p t i m @
asigurarea	a s i g u r a r e@ a
banilor	b a n i l o r
cheltuielile	k e l t u j e l i l e
radioului	r a d i o u l u j
jurnalismul	zh u r n a l i s m u l
opinie	o p i n i e
facultatea	f a k u l t a t e@ a
pitești	p i t e sh t ij
descoperit	d e s k o p e r i t
rețele	r e ts e l e
foști	f o sh t ij
colegi	k o l e dz ij
arădenii	a r @ d e n i j
speriați	s p e r i a ts ij
circule	ch i r k u l e
arad	a r a d
rutele	r u t e l e
săptămâna	s @ p t @ m a@ n a
controale	k o n t r o@ a l e
vizează	v i z e@ a z @
transport	t r a n s p o r t
capitala	k a p i t a l a
nord	n o r d
estul	e s t u l
ritmuri	r i t m u r ij
sumelor	s u m e l o r
restante	r e s t a n t e
cabinete	k a b i n e t e
distanță	d i s t a n ts @
corespundeau	k o r e s p u n d e@ a u
reglementărilor	r e g l e m e n t @ r i l o r
ministerului	m i n i s t e r u l u j
sănătății	s @ n @ t @ ts i j
elemente	e l e m e n t e
lucrezi	l u k r e z ij
atragem	a t r a dz e m
finanțarea	f i n a n ts a r e@ a
printrun	p r i n t r u n
republica	r e p u b l i k a
actuală	a k t u a l @
preocupați	p r e@ o k u p a ts ij
românii	r o m a@ n i j
străinătate	s t r @ i n @ t a t e
oftat	o f t a t
bărbatului	b @ r b a t u l u j
organizat	o r g a n i z a t
campionatul	k a m p j o n a t u l
național	n a ts j o n a l
audio	a u d j o
implementare	i m p l e m e n t a r e
rolul	r o l u l
supraveghea	s u p r a v e g e@ a
îndeplinirea	a@ n d e p l i n i r e@ a
obligațiilor	o b l i g a ts i j l o r
revin	r e v i n
părților	p @ r ts i l o r
convenție	k o n v e n ts i e
locația	l o k a ts i a
stabilită	s t a b i l i t @
inspectoratul	i n s p e k t o r a t u l
prelungit	p r e l u n dz i t
situată	s i t u a t @
centrul	ch e n t r u l
orașului	o r a sh u l u j
precizează	p r e ch i z e@ a z @
crivac	k r i v a k
prorectorii	p r o r e k t o r i j
universității	u n i v e r s i t @ ts i j
bune	b u n e
compania	k o m p a n i a
activități	a k t i v i t @ ts ij
imobiliare	i m o b i l i a r e
tehnologie	t e h n o l o dz i e
secundă	s e k u n d @
convorbirea	k o n v o r b i r e@ a
telefonică	t e l e f o n i k @
beșteleală	b e sh t e l e@ a l @
aplicată	a p l i k a t @
impetuozitatea	i m p e t u o z i t a t e@ a
sărmanului	s @ r m a n u l u j
cetățean	ch e t @ ts e@ a n
localitate	l o k a l i t a t e
concediu	k o n ch e d i w
ruptă	r u p t @
accesare	a k ch e s a r e
atras	a t r a s
durează	d u r e@ a z @
câștigă	k a@ sh t i g @
primirea	p r i m i r e@ a
avansului	a v a n s u l u j
bărcuțe	b @ r k u ts e
telecomandă	t e l e k o m a n d @
înconjurat	a@ n k o n zh u r a t
speranței	s p e r a n ts e j
cursă	k u r s @
blocul	b l o k u l
terminate	t e r m i n a t e
actele	a k t e l e
primărie	p r i m @ r i e
oboseala	o b o s e@ a l a
învățat	a@ n v @ ts a t
administrat	a d m i n i s t r a t
îngrijirile	a@ n g r i zh i r i l e
urgență	u r dz e n ts @
supraveghere	s u p r a v e g e r e
specialitate	s p e ch i a l i t a t e
viorica	v j o r i k a
crișan	k r i sh a n
muzeului	m u z e u l u j
eșecul	e sh e k u l
statului	s t a t u l u j
federal	f e d e r a l
cicloanelor	ch i k l o@ a n e l o r
profunde	p r o f u n d e
stigmate	s t i g m a t e
vânzări	v a@ n z @ r ij
debut	d e b u t
parfumul	p a r f u m u l
reflectă	r e f l e k t @
atitudinea	a t i t u d i n e@ a
unic	u n i k
cântăreața	k a@ n t @ r e@ a ts a
alcool	a l k o o l
fumatul	f u m a t u l
excesiv	e k s ch e s i v
carlton	k a r l t o n
situat	s i t u a t
cinsprezece	ch i n s p r e z e ch e
kilometri	k i l o m e t r ij
aeroportul	a e r o p o r t u l
angajeze	a n g a zh e z e
preoți	p r e o ts ij
băimărenii	b @ j m @ r e n i j
cumpăra	k u m p @ r a
familie	f a m i l i e
nepoți	n e p o ts ij
propagandist	p r o p a g a n d i s t
reprezentant	r e p r e z e n t a n t
activitate	a k t i v i t a t e
ilicit	i l i ch i t
atrage	a t r a dz e
sancțiuni	s a n k ts i u n ij
date	d a t e
comunitari	k o m u n i t a r ij
inspectorii	i n s p e k t o r i j
kilogram	k i l o g r a m
nemarcat	n e m a r k a t
bijuteriile	b i zh u t e r i j l e
recurs	r e k u r s
solicitat	s o l i ch i t a t
judecătorilor	zh u d e k @ t o r i l o r
eliberați	e l i b e r a ts ij
alătura	a l @ t u r a
colegilor	k o l e dz i l o r
protesta	p r o t e s t a
palatului	p a l a t u l u j
artiștii	a r t i sh t i j
armâni	a r m a@ n ij
îmbrăcați	a@ m b r @ k a ts ij
populare	p o p u l a r e
susținut	s u s ts i n u t
melodii	m e l o d i j
moscopole	m o s k o p o l e
magda	m a g d a
georgescu	dz e o@ r dz e s k u
maramureș	m a r a m u r e sh
demarată	d e m a r a t @
racordarea	r a k o r d a r e@ a
severinului	s e v e r i n u l u j
rețeaua	r e ts e@ a w a
constantin	k o n s t a n t i n
brâncoveanu	b r a@ n k o v e@ a n u
confruntă	k o n f r u n t @
gravă	g r a v @
lege	l e dz e
interzică	i n t e r z i k @
statut	s t a t u t
aprobat	a p r o b a t
necorelarea	n e k o r e l a r e@ a
simplistă	s i m p l i s t @
noile	n o j l e
nerăbdătoare	n e r @ b d @ t o@ a r e
lumină	l u m i n @
moscova	m o s k o v a
alexandru	a l e k s a n d r u
oancea	o@ a n ch e@ a
galați	g a l a ts ij
deprins	d e p r i n s
pasiunea	p a s i u n e@ a
ambarcațiuni	a m b a r k a ts i u n ij
traversat	t r a v e r s a t
năpustit	n @ p u s t i t
moral	m o r a l
medical	m e d i k a l
nască	n a s k @
honda	h o n d a
formula	f o r m u l a
cumpărat	k u m p @ r a t
devină	d e v i n @
operațional	o p e r a ts j o n a l
unsprezece	u n s p r e z e ch e
microbistă	m i k r o b i s t @
cunoaște	k u n o@ a sh t e
înțelege	a@ n ts e l e dz e
îndreptățiți	a@ n d r e p t @ ts i ts ij
luăm	l u @ m
primesc	p r i m e s k
rapoarte	r a p o@ a r t e
zilnice	z i l n i ch e
monitorizați	m o n i t o r i z a ts ij
grigore	g r i g o r e
anca	a n k a
comuna	k o m u n a
plopșoru	p l o p sh o r u
vecina	v e ch i n a
târâto	t a@ r a@ t o
altui	a l t u j
localnic	l o k a l n i k
construiește	k o n s t r u j e sh t e
amplasat	a m p l a s a t
radare	r a d a r e
cartofii	k a r t o f i j
prăjiți	p r @ zh i ts ij
safta	s a f t a
pândit	p a@ n d i t
semafor	s e m a f o r
bărbați	b @ r b a ts ij
consecințele	k o n s e ch i n ts e l e
catastrofale	k a t a s t r o f a l e
francez	f r a n ch e z
brun	b r u n
vicepreședintele	v i ch e p r e sh e d i n t e l e
cercetări	ch e r ch e t @ r ij
autoturismului	a u t o t u r i s m u l u j
fiat	f i a t
controlul	k o n t r o l u l
volanului	v o l a n u l u j
rutier	r u t i e r
străzi	s t r @ z ij
îngreunat	a@ n g r e u n a t
căruțași	k @ r u ts a sh ij
procesele	p r o ch e s e l e
dura	d u r a
mintaș	m i n t a sh
folcul	f o l k u l
spirit	s p i r i t
nopți	n o p ts ij
vară	v a r @
târgul	t a@ r g u l
reunește	r e u n e sh t e
importatori	i m p o r t a t o r ij
producători	p r o d u k @ t o r ij
comercianți	k o m e r ch i a n ts ij
felurile	f e l u r i l e
companie	k o m p a n i e
multinațională	m u l t i n a ts j o n a l @
poziția	p o z i ts i a
relaxare	r e l a k s a r e
evoluția	e v o l u ts i a
prețurilor	p r e ts u r i l o r
proprietarii	p r o p r i e t a r i j
rate	r a t e
tendința	t e n d i n ts a
variațiile	v a r i a ts i j l e
pieței	p i e ts e j
beznă	b e z n @
vagon	v a g o n
realitatea	r e@ a l i t a t e@ a
brațul	b r a ts u l
combină	k o m b i n @
complet	k o m p l e t
strivit	s t r i v i t
pictura	p i k t u r a
tabletă	t a b l e t @
minunat	m i n u n a t
consiliul	k o n s i l i w l
județean	zh u d e ts e@ a n
demara	d e m a r a
vânzarea	v a@ n z a r e@ a
policlinica	p o l i k l i n i k a
insule	i n s u l e
denumite	d e n u m i t e
teritoriile	t e r i t o r i j l e
japonia	zh a p o n i a
kurile	k u r i l e
ruși	r u sh ij
mămică	m @ m i k @
taibrek	t a j b r e k
argentinianul	a r dz e n t i n i a n u l
accepta	a k ch e p t a
comentatori	k o m e n t a t o r ij
nerealizare	n e r e@ a l i z a r e
coaliției	k o a l i ts i e j
finală	f i n a l @
decis	d e ch i s
seturi	s e t u r ij
stabile	s t a b i l e
cunoșteam	k u n o sh t e@ a m
portugalia	p o r t u g a l i a
dificultăți	d i f i k u l t @ ts ij
redacția	r e d a k ts i a
volumelor	v o l u m e l o r
făcute	f @ k u t e
strice	s t r i ch e
întreaga	a@ n t r e@ a g a
poveste	p o v e s t e
pepe	p e p e
petrina	p e t r i n a
ziarului	z i a r u l u j
cauzele	k a u z e l e
oficial	o f i ch i a l
faptul	f a p t u l
străzile	s t r @ z i l e
cerșetori	ch e r sh e t o r ij
susțin	s u s ts i n
rezultate	r e z u l t a t e
notabile	n o t a b i l e
lupta	l u p t a
cerșetoriei	ch e r sh e t o r i e j
bunurilor	b u n u r i l o r
salvate	s a l v a t e
depășește	d e p @ sh e sh t e
știrbesc	sh t i r b e s k
legitimate	l e dz i t i m a t e
cetățeni	ch e t @ ts e n ij
conduși	k o n d u sh ij
răzvan	r @ z v a n
cociș	k o ch i sh
oaspeți	o@ a s p e ts ij
erorile	e r o r i l e
doze	d o z e
vaccinului	v a k ch i n u l u j
gripei	g r i p e j
disponibile	d i s p o n i b i l e
autorizații	a u t o r i z a ts i j
eliberate	e l i b e r a t e
construcțiile	k o n s t r u k ts i i l e
rezidențiale	r e z i d e n ts i a l e
banat	b a n a t
grafic	g r a f i k
angajamentele	a n g a zh a m e n t e l e
asumate	a s u m a t e
protocolul	p r o t o k o l u l
ministerul	m i n i s t e r u l
transportului	t r a n s p o r t u l u j
vacă	v a k @
mașinii	m a sh i n i j
lucrărilor	l u k r @ r i l o r
tatăl	t a t @ l
îmbolnăvit	a@ m b o l n @ v i t
cancer	k a n ch e r
simțeam	s i m ts e@ a m
razna	r a z n a
georgică	dz e@ o r dz i k @
cornu	k o r n u
cristescu	k r i s t e s k u
analizează	a n a l i z e@ a z @
opțiune	o p ts i u n e
sticlă	s t i k l @
câștige	k a@ sh t i dz e
spațiu	s p a ts i w
nevăzătorii	n e v @ z @ t o r i j
pliant	p l i a n t
plastifiat	p l a s t i f i a t
limbajul	l i m b a zh u l
brai	b r a j
îndrumări	a@ n d r u m @ r ij
mașina	m a sh i n a
accelerează	a k ch e l e r e@ a z @
apostol	a p o s t o l
tarife	t a r i f e
decente	d e ch e n t e
oferite	o f e r i t e
revelion	r e v e l j o n
pensiuni	p e n s i u n ij
bucovina	b u k o v i n a
albac	a l b a k
arieșeni	a r i e sh e n ij
bușteni	b u sh t e n ij
lovea	l o v e@ a
aruncat	a r u n k a t
scaune	s k a u n e
studenților	s t u d e n ts i l o r
urmărit	u r m @ r i t
consecință	k o n s e ch i n ts @
înfățișare	a@ n f @ ts i sh a r e
echipament	e k i p a m e n t
persoană	p e r s o@ a n @
baltă	b a l t @
caldarâm	k a l d a r a@ m
clienții	k l i e n ts i j
clientela	k l i e n t e l a
părinților	p @ r i n ts i l o r
cumpărăturile	k u m p @ r @ t u r i l e
supermarchet	s u p e r m a r k e t
lipsesc	l i p s e s k
pesimiști	p e s i m i sh t ij
mândrit	m a@ n d r i t
crimele	k r i m e l e
comise	k o m i s e
despărțit	d e s p @ r ts i t
meciurile	m e ch j u r i l e
stelei	s t e l e j
campionilor	k a m p j o n i l o r
proceda	p r o ch e d a
judecătoria	zh u d e k @ t o r i a
slatina	s l a t i n a
manevra	m a n e v r a
redresare	r e d r e s a r e
fatală	f a t a l @
măsură	m @ s u r @
declară	d e k l a r @
bazac	b a z a k
cercetat	ch e r ch e t a t
penal	p e n a l
ardud	a r d u d
lovire	l o v i r e
îngropat	a@ n g r o p a t
dezamăgit	d e z a m @ dz i t
leam	l e@ a m
fotbaliștilor	f o t b a l i sh t i l o r
dulca	d u l k a
relație	r e l a ts i e
durabilă	d u r a b i l @
apropiat	a p r o p i a t
pilotului	p i l o t u l u j
judecătorii	zh u d e k @ t o r i j
respectă	r e s p e k t @
persoanelor	p e r s o@ a n e l o r
afecțiuni	a f e k ts i u n i
psihice	p s i h i ch e
plimba	p l i m b a
depinde	d e p i n d e
descurc	d e s k u r k
valentin	v a l e n t i n
îmbujorat	a@ m b u zh o r a t
ajungi	a zh u n dz ij
scărilor	s k @ r i l o r
întâmpină	a@ n t a@ m p i n e
statuia	s t a t u j a
străjer	s t r @ zh e r
banca	b a n k a
reprezintă	r e p r e z i n t @
imediată	i m e d i a t @
venituri	v e n i t u r ij
născută	n @ s k u t @
prematur	p r e m a t u r
moartă	m o@ a r t @
inițial	i n i ts i a l
micuței	m i k u ts e j
medie	m e d i e
spectacole	s p e k t a k o l e
declanșarea	d e k l a n sh a r e@ a
migrenelor	m i g r e n e l o r
neurotransmițătorul	n e u r o t r a n s m i ts @ t o r u l
micii	m i ch i j
meșteșugari	m e sh t e sh u g a r ij
atelierele	a t e l i e r e l e
reparat	r e p a r a t
afectați	a f e k t a ts ij
apariția	a p a r i ts i a
urmare	u r m a r e
asociații	a s o ch i a ts i j
adrese	a d r e s e
cerând	ch e r a@ n d
scoase	s k o@ a s e
record	r e k o r d
îndepărtata	a@ n d e p @ r t a t a
irlandă	i r l a n d @
serios	s e r i o s
gândit	g a@ n d i t
negociere	n e g o ch i e r e
accidentului	a k ch i d e n t u l u j
tânărul	t a@ n @ r u l
suferit	s u f e r i t
leziuni	l e z i u n ij
multiple	m u l t i p l e
observ	o p s e r v
progrese	p r o g r e s e
sfidător	s f i d @ t o r
adresa	a d r e s a
scor	s k o r
liberalii	l i b e r a l i j
guvernare	g u v e r n a r e
opoziție	o p o z i ts i e
imposibil	i m p o s i b i l
repete	r e p e t e
participat	p a r t i ch i p a t
prezentate	p r e z e n t a t e
vasile	v a s i l e
spiridon	s p i r i d o n
aurelia	a u r e l i a
goci	g o ch ij
voinescu	v o j n e s k u
mortu	m o r t u
incomplet	i n k o m p l e t
imperfect	i m p e r f e k t
manuscrisul	m a n u s k r i s u l
descifrabil	d e s ch i f r a b i l
nervoasă	n e r v o@ a s @
profesoara	p r o f e s o@ a r a
engleză	e n g l e z @
sala	s a l a
găsită	g @ s i t @
arheologică	a r h e@ o l o dz i k @
domus	d o m u s
aurea	a u r e a
începere	a@ n ch e p e r e
papagalul	p a p a g a l u l
alina	a l i n a
proprietar	p r o p r i e t a r
borcea	b o r ch e@ a
comportat	k o m p o r t a t
vestiar	v e s t i a r
uniunea	u n i u n e@ a
suplimenteze	s u p l i m e n t e z e
timpi	t i m p ij
mișcări	m i sh k @ r ij
dărâmat	d @ r a@ m a t
gardul	g a r d u l
instrumentală	i n s t r u m e n t a l @
concert	k o n ch e r t
penitenciarul	p e n i t e n ch i a r u l
rahova	r a h o v a
posturile	p o s t u r i l e
mecanic	m e k a n i k
solicitanți	s o l i ch i t a n ts ij
finalizat	f i n a l i z a t
iulie	j u l i e
procurorul	p r o k u r o r u l
replică	r e p l i k @
negat	n e g a t
satriani	s a t r i a n i
scris	s k r i s
melodie	m e l o d i e
influențat	i n f l u e n ts a t
agenții	a dz e n ts i j
economici	e k o n o m i ch ij
impozit	i m p o z i t
proporție	p r o p o r ts i e
testarea	t e s t a r e@ a
patra	p a t r a
economică	e k o n o m i k @
negativă	n e g a t i v @
cheltuielilor	k e l t u j e l i l o r
excepții	e k s ch e p ts i j
filat	f i l a t
promite	p r o m i t e
reglementarea	r e g l e m e n t a r e@ a
limbii	l i m b i j
sentiment	s e n t i m e n t
cuvine	k u v i n e
contencios	k o n t e n ch j o s
simplu	s i m p l u
reprezentanți	r e p r e z e n t a n ts ij
tabloul	t a b l o w l
artcurial	a r t k u r i a l
licitație	l i ch i t a ts i e
anual	a n u a l
piesă	p i e s @
istorică	i s t o r i k @
aparține	a p a r ts i n e
celebrități	ch e l e b r i t @ ts ij
scopuri	s k o p u r ij
problemele	p r o b l e m e l e
delectează	d e l e k t e@ a z @
părinții	p @ r i n ts i j
minorului	m i n o r u l u j
pedepsit	p e d e p s i t
încerc	a@ n ch e r k
tradițiile	t r a d i ts i j l e
localitatea	l o k a l i t a t e@ a
doljeană	d o l zh e@ a n @
sadova	s a d o v a
dogari	d o g a r ij
postbelică	p o s t b e l i k @
pacifistă	p a ch i f i s t @
puternică	p u t e r n i k @
ieri	j e r ij
anglia	a n g l i a
sătmăreanul	s @ t m @ r e@ a n u l
mureșan	m u r e sh a n
naturist	n a t u r i s t
extracte	e k s t r a k t e
plante	p l a n t e
păcate	p @ k a t e
statul	s t a t u l
tirului	t i r u l u j
leziune	l e z i u n e
cameramani	k a m e r a m a n ij
pază	p a z @
corp	k o r p
trenul	t r e n u l
șine	sh i n e
răsturnat	r @ s t u r n a t
impresionat	i m p r e s j o n a t
proiectului	p r o j e k t u l u j
liceul	l i ch e w l
silvic	s i l v i k
dispoziția	d i s p o z i ts i a
cercetătorilor	ch e r ch e t @ t o r i l o r
curtea	k u r t e@ a
școlii	sh k o l i j
investit	i n v e s t i t
construcția	k o n s t r u k ts i a
hoteluri	h o t e l u r ij
cazinouri	k a z i n o w r ij
existe	e g z i s t e
înțelegere	a@ n ts e l e dz e r e
cooperare	k o o p e r a r e
reciprocă	r e ch i p r o k @
apreciază	a p r e ch i a z @
punctualitatea	p u n k t w a l i t a t e@ a
vernisaj	v e r n i s a zh
criticul	k r i t i k u l
artă	a r t @
șușară	sh u sh a r @
horia	h o r i a
vorbim	v o r b i m
studenți	s t u d e n ts ij
operațiunea	o p e r a ts i u n e@ a
săptămâni	s @ p t @ m a@ n ij
tresăream	t r e s @ r e@ a m
auzeam	a u z e@ a i
sirene	s i r e n e
târgoviște	t a@ r g o v i sh t e
preferă	p r e f e r @
repare	r e p a r e
cumpere	k u m p e r e
ceară	ch e@ a r @
carmen	k a r m e n
bejan	b e zh a n
sergiu	s e r dz j u
florea	f l o r e@ a
vino	v i n o
tratatul	t r a t a t u l
vigoare	v i g o@ a r e
ratificat	r a t i f i k a t
state	s t a t e
operații	o p e r a ts i j
teribila	t e r i b i l a
ajungă	a zh u n g @
simțim	s i m ts i m
protestele	p r o t e s t e l e
francezilor	f r a n ch e z i l o r
lapte	l a p t e
șofer	sh o f e r
volan	v o l a n
băut	b @ u t
stejărel	s t e zh @ r e l
fire	f i r e
suportă	s u p o r t @
atenției	a t e n ts i e j
atrag	a t r a g
atenția	a t e n ts i a
cetățenilor	ch e t @ ts e n i l o r
milogilor	m i l o dz i l o r
deosebite	d e o s e b i t e
salon	s a l o n
specialiștii	s p e ch i a l i sh t i j
stafuri	s t a f u r ij
memoria	m e m o r i a
vezprem	v e z p r e m
lambu	l a m b u
alergat	a l e r g a t
trimiși	t r i m i sh ij
profesorul	p r o f e s o r u l
dumitru	d u m i t r u
ciuboată	ch j u b o@ a t @
petrescu	p e t r e s k u
observe	o p s e r v e
prejudecăți	p r e zh u d e k @ ts ij
privința	p r i v i n ts a
credeți	k r e d e ts ij
diferență	d i f e r e n ts @
meseriașii	m e s e r i a sh i j
pornit	p o r n i t
costum	k o s t u m
închiria	a@ n k i r i a
costă	k o s t @
vineri	v i n e r ij
codul	k o d u l
săvârșirea	s @ v a@ r sh i r e@ a
infracțiunii	i n f r a k ts i u n i j
prostituăm	p r o s t i t u @ m
recuperăm	r e k u p e r @ m
credincioși	k r e d i n ch j o sh ij
speră	s p e r @
beneficieze	b e n e f i ch i e z e
serviciile	s e r v i ch i j l e
multor	m u l t o r
investitor	i n v e s t i t o r
depind	d e p i n d
salariul	s a l a r i w l
ăsta	@ s t a
câlnic	k a@ l n i k
gurii	g u r i j
trecută	t r e k u t @
mânca	m a@ n k a
locuiau	l o k u j a w
copilăriseră	k o p i l @ r i s e r @
filmul	f i l m u l
rulează	r u l e@ a z @
avanpremieră	a v a n p r e m i e r @
cinema	ch i n e m a
odeon	o d e@ o n
pasul	p a s u l
ligă	l i g @
util	u t i l
dispus	d i s p u s
europă	e u r o p @
asculte	a s k u l t e
fredoneze	f r e d o n e z e
melodia	m e l o d i a
compusă	k o m p u s @
ucenicia	u ch e n i ch i a
meserie	m e s e r i e
unitățile	u n i t @ ts i l e
autorizație	a u t o r i z a ts i e
curentă	k u r e n t @
canalizare	k a n a l i z a r e
grupurile	g r u p u r i l e
sanitare	s a n i t a r e
neconforme	n e k o n f o r m e
afirmația	a f i r m a ts i a
confirmată	k o n f i r m a t @
inspectoratului	i n s p e k t o r a t u l u j
cruciulițele	k r u ch i w l i ts e l e
brodează	b r o d e@ a z @
viteză	v i t e z @
măsura	m @ s u r a
talentul	t a l e n t u l
serie	s e r i e
întrebări	a@ n t r e b @ r ij
neobișnuite	n e o b i sh n u i t e
meseria	m e s e r i a
ajută	a zh u t @
treaptă	t r e@ a p t @
ierarhică	j e r a r h i k @
albinaru	a l b i n a r u
știința	sh t i i n ts a
arătat	a r @ t a t
comparație	k o m p a r a ts i e
precedentele	p r e ch e d e n t e l e
deplasări	d e p l a s @ r ij
mute	m u t e
dintrun	d i n t r u n
sector	s e k t o r
stadionului	s t a d i o n u l u j
procedura	p r o ch e d u r a
holul	h o l u l
complexului	k o m p l e k s u l u j
muzeal	m u z e@ a l
iulian	j u l i a n
antonescu	a n t o n e s k u
deranjează	d e r a n zh e@ a z @
visează	v i s e@ a z @
finala	f i n a l a
cupei	k u p e j
filmului	f i l m u l u j
repet	r e p e t
umilire	u m i l i r e
demnității	d e m n i t @ ts i j
țării	ts @ r i j
șoferi	sh o f e r ij
autocarului	a u t o k a r u l u j
surprins	s u r p r i n s
flăcări	f l @ k @ r ij
piteștenii	p i t e sh t e n i j
impuseseră	i m p u s e s e r @
georgeta	dz e@ o r dz e t a
fetiță	f e t i ts @
imens	i m e n s
economie	e k o n o m i e
prăbușească	p r @ b u sh e@ a s k @
frigider	f r i dz i d e r
ținut	ts i n u t
tănăsescu	t @ n @ s e s k u
templul	t e m p l u l
turiști	t u r i sh t ij
acuzată	a k u z a t @
infracțiunilor	i n f r a k ts i u n i l o r
înșelăciune	a@ n sh e l @ ch j u n e
înscrisuri	a@ n s k r i s u r ij
semnătură	s e m n @ t u r @
privată	p r i v a t @
investitorii	i n v e s t i t o r i j
plasamente	p l a s a m e n t e
indicii	i n d i ch i j
bursieri	b u r s i e r ij
intervalul	i n t e r v a l u l
analizat	a n a l i z a t
educație	e d u k a ts i e
mică	m i k @
trai	t r a j
decent	d e ch e n t
baloanele	b a l o@ a n e l e
ambii	a m b i j
părăsit	p @ r @ s i t
cantonamentul	k a n t o n a m e n t u l
răspândi	r @ s p a@ n d i
virusul	v i r u s u l
celorlalți	ch e l o r l a l ts ij
fotbaliști	f o t b a l i sh t ij
ziare	z i a r e
mazăre	m a z @ r e
întâmpla	a@ n t a@ m p l a
capitală	k a p i t a l @
lazic	l a z i k
folosit	f o l o s i t
mariana	m a r i a n a
gâju	g a@ zh u
folosi	f o l o s i
târnoveanca	t a@ r n o v e@ a n k a
serbia	s e r b i a
franței	f r a n ts e j
individuală	i n d i v i d w a l @
basarabeni	b a s a r a b e n ij
cadouri	k a d o u r ij
municipiului	m u n i ch i p j u l u j
alba	a l b a
iulia	j u l i a
vârstă	v a@ r s t @
conducea	k o n d u ch e@ a
înmatriculat	a@ n m a t r i k u l a t
casei	k a s e j
crăpat	k r @ p a t
rezolvării	r e z o l v @ r i j
lucrurilor	l u k r u r i l o r
salarii	s a l a r i j
cuprinde	k u p r i n d e
literar	l i t e r a r
artistică	a r t i s t i k @
petrecere	p e t r e ch e r e
metrorex	m e t r o r e k s
tăcut	t @ k u t
meselor	m e s e l o r
pensionari	p e n s j o n a r ij
partidul	p a r t i d u l
socialdemocrat	s o ch i a l d e m o k r a t
înfrângere	a@ n f r a@ n dz e r e
precedent	p r e ch e d e n t
angajați	a n g a zh a ts ij
eveniment	e v e n i m e n t
audiați	a u d i a ts ij
continua	k o n t i n w a
acționa	a k ts j o n a
eficient	e f i ch i e n t
domeniile	d o m e n i i l e
producția	p r o d u k ts i a
imobiliar	i m o b i l i a r
suspiciuni	s u s p i ch i u n ij
anunțe	a n u n ts e
confirma	k o n f i r m a
trafic	t r a f i k
festivalul	f e s t i v a l u l
prioritatea	p r j o r i t a t e@ a
dumitrel	d u m i t r e l
personajul	p e r s o n a zh u l
pictor	p i k t o r
recunoaștere	r e k u n o@ a sh t e r e
candidații	k a n d i d a ts i j
municipal	m u n i ch i p a l
recurg	r e k u r g
felul	f e l u l
voluntari	v o l u n t a r ij
militanți	m i l i t a n ts ij
încercat	a@ n ch e r k a t
glumește	g l u m e sh t e
învinge	a@ n v i n dz e
hotărâți	h o t @ r a@ ts ij
sensul	s e n s u l
cuvântului	k u v a@ n t u l u j
mușcăm	m u sh k @ m
bucur	b u k u r
reușita	r e u sh i t a
pregăti	p r e g @ t i
surpriză	s u r p r i z @
doina	d o j n a
petrean	p e t r e@ a n
proteză	p r o t e z @
sponsorizare	s p o n s o r i z a r e
reprezenta	r e p r e z e n t a
motivul	m o t i v u l
completat	k o m p l e t a t
anghel	a n g e l
romilor	r o m i l o r
amenință	a m e n i n ts @
bătaie	b @ t a j e
oasele	o@ a s e l e
rupte	r u p t e
anii	a n i j
terorii	t e r o r i j
galben	g a l b e n
turnurilor	t u r n u r i l o r
scară	s k a r @
exterioară	e k s t e r j o a r @
turiștii	t u r i sh t i j
urca	u r k a
cupola	k u p o l a
bisericii	b i s e r i ch i j
căminul	k @ m i n u l
poligrafie	p o l i g r a f i e
paturi	p a t u r ij
palier	p a l i e r
însoțită	a@ n s o ts i t @
râsete	r a@ s e t e
frecvente	f r e k v e n t e
ropote	r o p o t e
aplauze	a p l a u z e
impactului	i m p a k t u l u j
pasagera	p a s a dz e r a
dreapta	d r e@ a p t a
ului	u l u i
rănită	r @ n i t @
lase	l a s e
descurcau	d e s k u r k a w
secțiile	s e k ts i i l e
spitalului	s p i t a l u l u j
operator	o p e r a t o r
secția	s e k ts i a
născuți	n @ s k u ts ij
problema	p r o b l e m a
lipsei	l i p s e j
lenjeriei	l e n zh e r i e j
curate	k u r a t e
grilă	g r i l @
salarizare	s a l a r i z a r e
profesori	p r o f e s o r ij
oricine	o r i ch i n e
dubleze	d u b l e z e
vocile	v o ch i l e
actorilor	a k t o r i l o r
societăți	s o ch i e t @ ts ij
cipriote	ch i p r j o t e
bănci	b @ n ch ij
soldați	s o l d a ts ij
vătămați	v @ t @ m a ts ij
fată	f a t @
cumpăram	k u m p @ r a m
reviste	r e v i s t e
arădean	a r @ d e@ a n
handbalistele	h a n d b a l i s t e l e
premiate	p r e m i a t e
erica	e r i k a
secretară	s e k r e t a r @
baschet	b a s k e t
bezele	b e z e l e
apelului	a p e l u l u j
sosit	s o s i t
încarcerată	a@ n k a r ch e r a t @
respectul	r e s p e k t u l
viză	v i z @
radio	r a d j o
semnale	s e m n a l e
alarmă	a l a r m @
apreciat	a p r e ch i a t
jucător	zh u k @ t o r
rămână	r @ m a@ n @
șfaițer	sh f a j ts e r
elaborare	e l a b o r a r e
codului	k o d u l u j
ignorat	i g n o r a t
asigurărilor	a s i g u r @ r i l o r
municipiul	m u n i ch i p j u l
bacău	b a k @ u
brio	b r i o
crizei	k r i z e j
anunțul	a n u n ts u l
săptămânii	s @ p t @ m a@ n i j
precizând	p r e ch i z a@ n d
studiez	s t u d i e z
vină	v i n @
cafenea	k a f e n e@ a
bujanovaci	b u zh a n o v a ch ij
presevo	p r e s e v o
majoritar	m a zh o r i t a r
albaneză	a l b a n e z @
comerțul	k o m e r ts u l
ambulant	a m b u l a n t
întregește	a@ n t r e dz e sh t e
dezolantă	d e z o l a n t @
pierdute	p i e r d u t e
marile	m a r i l e
orașe	o r a sh e
acordă	a k o r d @
gratuitate	g r a t u j t a t e
elevilor	e l e v i l o r
rest	r e s t
neconcludente	n e k o n k l u d e n t e
indicat	i n d i k a t
pilotul	p i l o t u l
scăzută	s k @ z u t @
sodiu	s o d i w
gălețile	g @ l e ts i l e
motorină	m o t o r i n @
localnicii	l o k a l n i ch i j
jumătatea	zh u m @ t a t e@ a
lunii	l u n i j
discuta	d i s k u t a
secției	s e k ts i e j
petrochimie	p e t r o k i m i e
timiș	t i m i sh
atragerea	a t r a dz e r e@ a
europeni	e u r o p e n ij
necesari	n e ch e s a r ij
renovării	r e n o v @ r i j
centrului	ch e n t r u l u j
sistem	s i s t e m
agenda	a dz e n d a
îndrăgitei	a@ n d r @ dz i t e j
cântărețe	k a@ n t @ r e ts e
raportat	r a p o r t a t
tehnica	t e h n i k a
tehnologic	t e h n o l o dz i k
amploare	a m p l o@ a r e
repriza	r e p r i z a
timișorenii	t i m i sh o r e n i j
dezlănțuit	d e z l @ n ts u i t
înscris	a@ n s k r i s
ananghie	a n a n g i e
mărturisește	m @ r t u r i s e sh t e
rost	r o s t
chinui	k i n u i
ultimele	u l t i m e l e
modernă	m o d e r n @
prezentat	p r e z e n t a t
prototipul	p r o t o t i p u l
maestrului	m a e s t r u l u j
angelo	a n dz e l o
rovența	r o v e n ts a
student	s t u d e n t
competiție	k o m p e t i ts i e
cuprinsă	k u p r i n s @
credincioșii	k r e d i n ch j o sh i j
lumânări	l u m a@ n @ r ij
teribilă	t e r i b i l @
întărește	a@ n t @ r e sh t e
master	m a s t e r
supus	s u p u s
aprobării	a p r o b @ r i j
consiliului	k o n s i l i w l u j
eclectică	e k l e k t i k @
disfuncționalități	d i s f u n k ts j o n a l i t @ ts ij
planetariul	p l a n e t a r i w l
baia	b a j a
propune	p r o p u n e
cultural	k u l t u r a l
trag	t r a g
semnalul	s e m n a l u l
acestuia	a ch e s t u j a
transportați	t r a n s p o r t a ts ij
obține	o p ts i n e
stratul	s t r a t u l
frunzelor	f r u n z e l o r
concediați	k o n ch e d i a ts ij
sindicatului	s i n d i k a t u l u j
liber	l i b e r
iaurt	j a u r t
iertat	j e r t a t
magistrați	m a dz i s t r a ts ij
rânduri	r a@ n d u r ij
lipit	l i p i t
afișe	a f i sh e
cazărilor	k a z @ r i l o r
neclarități	n e k l a r i t @ ts ij
iordache	j o r d a k e
învățământul	a@ n v @ ts @ m a@ n t u l
dorește	d o r e sh t e
dubai	d u b a j
dani	d a n ij
coman	k o m a n
parade	p a r a d e
senzaționale	s e n z a ts j o n a l e
modul	m o d u l
administrației	a d m i n i s t r a ts i e j
publice	p u b l i ch e
județene	zh u d e ts e n e
absorbția	a p s o r p ts i a
fondurilor	f o n d u r i l o r
campanie	k a m p a n i e
tombolă	t o m b o l @
premii	p r e m i j
ofertă	o f e r t @
lucra	l u k r a
acceptao	a k ch e p t a o
bugetul	b u dz e t u l
prognozat	p r o g n o z a t
procente	p r o ch e n t e
tragem	t r a dz e m
linie	l i n i e
factor	f a k t o r
supraviețuiești	s u p r a v i e ts u j e sh t ij
credința	k r e d i n ts a
fermă	f e r m @
valori	v a l o r ij
mariei	m a r i e j
lungu	l u n g u
însușinduși	a@ n s u sh i n d u sh ij
cunoștințe	k u n o sh t i n ts e
elementare	e l e m e n t a r e
matematică	m a t e m a t i k @
concepe	k o n ch e p e
trăită	t r @ i t @
indiferență	i n d i f e r e n ts @
publicitate	p u b l i ch i t a t e
stabilit	s t a b i l i t
denumit	d e n u m i t
vizita	v i z i t a
categoria	k a t e g o r i a
concurență	k o n k u r e n ts @
alecu	a l e k u
pregătește	p r e g @ t e sh t e
internaționale	i n t e r n a ts j o n a l e
apreciez	a p r e ch i e z
acțiune	a k ts i u n e
câinilor	k a@ j n i l o r
reducă	r e d u k @
gheorghița	g e@ o r g i ts a
dina	d i n a
ascund	a s k u n d
acțiuni	a k ts i u n i
politic	p o l i t i k
consolidarea	k o n s o l i d a r e@ a
impusă	i m p u s @
inundațiilor	i n u n d a ts i j l o r
libertatea	l i b e r t a t e@ a
luptat	l u p t a t
armată	a r m a t @
muncit	m u n ch i t
cemi	ch e m ij
trebuia	t r e b u j a
împărtășit	a@ m p @ r t @ sh i t
informațiile	i n f o r m a ts i j l e
primite	p r i m i t e
dedicat	d e d i k a t
eficienței	e f i ch i e n ts e j
sectorul	s e k t o r u l
privat	p r i v a t
tinde	t i n d e
atracția	a t r a k ts i a
jafuri	zh a f u r ij
operatori	o p e r a t o r ij
turism	t u r i s m
ucraina	u k r a i n a
clandestin	k l a n d e s t i n
agroalimentare	a g r o@ a l i m e n t a r e
neamțul	n e@ a m ts u l
preluării	p r e l w @ r i j
ureche	u r e k e
suveranul	s u v e r a n u l
alunge	a l u n dz e
practicat	p r a k t i k a t
realizarea	r e@ a l i z a r e@ a
oricărui	o r i k @ r u j
sait	s a j t
lunar	l u n a r
criș	k r i sh
create	k r e@ a t e
firește	f i r e sh t e
reducem	r e d u ch e m
comisarilor	k o m i s a r i l o r
regăsit	r e g @ s i t
solid	s o l i d
trupa	t r u p a
grigoraș	g r i g o r a sh
oltenilor	o l t e n i l o r
victima	v i k t i m a
maghiară	m a g i a r @
specializare	s p e ch i a l i z a r e
prefectul	p r e f e k t u l
loredana	l o r e d a n a
premiată	p r e m i a t @
comisia	k o m i s i a
internațională	i n t e r n a ts j o n a l @
protecția	p r o t e k ts i a
fluviului	f l u v i w l u j
dunărea	d u n @ r e@ a
îmbin	a@ m b i n
plăcutul	p l @ k u t u l
păcatul	p @ k a t u l
inspiră	i n s p i r @
teamă	t e@ a m @
administrație	a d m i n i s t r a ts i e
ajutăm	a zh u t @ m
firme	f i r m e
corn	k o r n
produsele	p r o d u s e l e
elaborat	e l a b o r a t
culegeri	k u l e dz e r ij
poeți	p o e ts ij
cenaclului	ch e n a k l u l u j
semenicul	s e m e n i k u l
antrenament	a n t r e n a m e n t
sportivii	s p o r t i v i j
slătineni	s l @ t i n e n ij
desfășoară	d e s f @ sh o@ a r @
tatamii	t a t a m i j
antrenamente	a n t r e n a m e n t e
neconfirmării	n e k o n f i r m @ r i j
locului	l o k u l u j
neocupate	n e o k u p a t e
redistribuite	r e d i s t r i b u i t e
dușmănesc	d u sh m @ n e s k
creștinismul	k r e sh t i n i s m u l
directă	d i r e k t @
felului	f e l u l u j
proiectat	p r o j e k t a t
deprinderi	d e p r i n d e r ij
convingerea	k o n v i n dz e r e@ a
definește	d e f i n e sh t e
ieșenilor	j e sh e n i l o r
conformitate	k o n f o r m i t a t e
normele	n o r m e l e
construcții	k o n s t r u k ts i j
vistieria	v i s t i e r i a
tranșă	t r a n sh @
împrumutului	a@ m p r u m u t u l u j
termenul	t e r m e n u l
depunerea	d e p u n e r e@ a
decembrie	d e ch e m b r i e
fiul	f i w l
imigranți	i m i g r a n ts ij
veniți	v e n i ts ij
mondial	m o n d i a l
suspiciune	s u s p i ch i u n e
epizootie	e p i z o o t i e
durat	d u r a t
cursul	k u r s u l
soluția	s o l u ts i a
găsito	g @ s i t o
folosește	f o l o s e sh t e
metoda	m e t o d a
ecologică	e k o l o dz i k @
portughezi	p o r t u g e z ij
moldovenii	m o l d o v e n i j
întrecerea	a@ n t r e ch e r e@ a
internă	i n t e r n @
prinși	p r i n sh ij
scape	s k a p e
scenariul	s ch e n a r i w l
semiblocajului	s e m i b l o k a zh u l u j
actuala	a k t w a l a
conducere	k o n d u ch e r e
continuitate	k o n t i n u j t a t e
indirect	i n d i r e k t
femeile	f e m e j l e
cealaltă	ch e@ a l a l t @
rugat	r u g a t
fațadei	f a ts a d e j
terminat	t e r m i n a t
micul	m i k u l
muzician	m u z i ch i a n
detest	d e t e s t
caracter	k a r a k t e r
unora	u n o r a
achita	a k i t a
băutura	b @ u t u r a
rafinată	r a f i n a t @
august	a w g u s t
șomeri	sh o m e r ij
milanezii	m i l a n e z i j
campioanei	k a m p j o a n e j
rubin	r u b i n
kazan	k a z a n
liniștit	l i n i sh t i t
prilejuit	p r i l e zh u i t
confecționeze	k o n f e k ts j o n e z e
instrumente	i n s t r u m e n t e
muzicale	m u z i k a l e
demonstrăm	d e m o n s t r @ m
civilizat	ch i v i l i z a t
prefer	p r e f e r
sporturile	s p o r t u r i l e
legate	l e g a t e
motor	m o t o r
oliver	o l i v e r
ideile	i d e j l e
vacarm	v a k a r m
achiziționarea	a k i z i ts j o n a r e@ a
demararea	d e m a r a r e@ a
modernizarea	m o d e r n i z a r e@ a
întregii	a@ n t r e dz i j
pița	p i ts a
preparată	p r e p a r a t @
oferită	o f e r i t @
gratuit	g r a t u i t
participanților	p a r t i ch i p a n ts i l o r
campaniei	k a m p a n i e j
infracționalitatea	i n f r a k ts j o n a l i t a t e@ a
tipurile	t i p u r i l e
valabile	v a l a b i l e
abonamentele	a b o n a m e n t e l e
premieră	p r e m i e r @
gestionarea	dz e s t j o n a r e@ a
deșeurilor	d e sh e w r i l o r
baza	b a z a
prevederilor	p r e v e d e r i l o r
autorizația	a u t o r i z a ts i a
mediu	m e d i w
obligați	o b l i g a ts ij
arbitrii	a r b i t r i j
rezervă	r e z e r v @
dănilă	d @ n i l @
demisionat	d e m i s j o n a t
executiv	e g z e k u t i v
carnet	k a r n e t
opri	o p r i
rămânem	r @ m a@ n e m
prosteala	p r o s t e@ a l a
îndeaproape	a@ n d e@ a p r o@ a p e
istoria	i s t o r i a
postdecembristă	p o s t d e ch e m b r i s t @
prezentați	p r e z e n t a ts ij
parchetului	p a r k e t u l u j
turda	t u r d a
propunere	p r o p u n e r e
arestare	a r e s t a r e
preventivă	p r e v e n t i v @
remaniez	r e m a n i e z
idealul	i d e@ a l u l
teza	t e z a
doctorat	d o k t o r a t
favorită	f a v o r i t @
prioritățile	p r j o r i t @ ts i l e
conjuncturi	k o n zh u n k t u r ij
îndemânare	a@ n d e m a@ n a r e
mutilată	m u t i l a t @
marcat	m a r k a t
numărului	n u m @ r u l u j
concedii	k o n ch e d i j
cauze	k a u z e
niciunul	n i ch i u n u l
indispensabil	i n d i s p e n s a b i l
francezii	f r a n ch e z i j
adevărată	a d e v @ r a t @
tradiție	t r a d i ts i e
fabricarea	f a b r i k a r e@ a
băuturi	b @ u t u r ij
blugi	b l u dz ij
tentat	t e n t a t
revenire	r e v e n i r e
federației	f e d e r a ts i e j
brand	b r a n d
brânza	b r a@ n z a
gemurile	dz e m u r i l e
doare	d o@ a r e
penalizați	p e n a l i z a ts ij
partidă	p a r t i d @
compara	k o m p a r a
gâtul	g a@ t u l
necesitat	n e ch e s i t a t
intervenție	i n t e r v e n ts i e
dezvoltă	d e z v o l t @
anumită	a n u m i t @
minuțiozitate	m i n u ts j o z i t a t e
comentariul	k o m e n t a r i w l
novosti	n o v o s t i
grămezi	g r @ m e z ij
uriașe	u r i a sh e
schimbat	s k i m b a t
geantă	dz e@ a n t @
delegări	d e l e g @ r ij
modă	m o d @
califice	k a l i f i ch e
stația	s t a ts i a
market	m a r k e t
funcțională	f u n k ts j o n a l @
durata	d u r a t a
imobilizeze	i m o b i l i z e z e
bărbat	b @ r b a t
supravegherea	s u p r a v e g e r e@ a
personalului	p e r s o n a l u l u j
retrag	r e t r a g
autotrenul	a u t o t r e n u l
cantitatea	k a n t i t a t e@ a
țigări	ts i g @ r ij
predate	p r e d a t e
inspectorilori	i n s p e k t o r i l o r ij
vamali	v a m a l ij
oncescu	o n ch e s k u
atenți	a t e n ts ij
agenți	a dz e n ts ij
acoperire	a k o p e r i r e
ascunsă	a s k u n s @
neregulile	n e r e g u l i l e
ocazia	o k a z i a
prezentăm	p r e z e n t @ m
front	f r o n t
unit	u n i t
qaida	k a i d a
revendicat	r e v e n d i k a t
atacurile	a t a k u r i l e
arată	a r a t @
rozalia	r o z a l i a
șutat	sh u t a t
liberă	l i b e r @
giuleșteană	dz i w l e sh t e@ a n @
cronjaeger	k r o n j e g e r
renunțat	r e n u n ts a t
contraexpertiză	k o n t r a e k s p e r t i z @
domeniul	d o m e n j u l
vânzării	v a@ n z @ r i j
castanelor	k a s t a n e l o r
otrăvită	o t r @ v i t @
veți	v e ts ij
acei	a ch e j
călătoresc	k @ l @ t o r e s k
aparte	a p a r t e
dansează	d a n s e@ a z @
vaslui	v a s l u j
vama	v a m a
albița	a l b i ts a
românesc	r o m a@ n e s k
etapă	e t a p @
avânt	a v a@ n t
dețin	d e ts i j
fierar	f i e r a r
betonist	b e t o n i s t
echipele	e k i p e l e
reproșuri	r e p r o sh u r ij
arbitrajelor	a r b i t r a zh e l o r
irlanda	i r l a n d a
respinge	r e s p i n dz e
ratificarea	r a t i f i k a r e@ a
tratatului	t r a t a t u l u j
nefericire	n e f e r i ch i r e
financiar	f i n a n ch i a r
artistului	a r t i s t u l u j
neseriozitatea	n e s e r j o z i t a t e@ a
strâng	s t r a@ n g
manual	m a n u a l
viceprimarul	v i ch e p r i m a r u l
ionică	j o n i k @
puțină	p u ts i n @
explicat	e k s p l i k a t
mădălina	m @ d @ l i n a
renovez	r e n o v e z
termină	t e r m i n @
tehnologia	t e h n o l o dz i a
accident	a k ch i d e n t
șoferița	sh o f e r i ts a
uneia	u n e j a
datoriile	d a t o r i j l e
lotul	l o t u l
numeros	n u m e r o s
tricouri	t r i k o w r ij
epoca	e p o k a
caritas	k a r i t a s
învinuiții	a@ n v i n u i ts i j
luați	l w a ts ij
duși	d u sh ij
efectul	e f e k t u l
interesul	i n t e r e s u l
scăzut	s k @ z u t
vedere	v e d e r e
fizic	f i z i k
gradul	g r a d u l
bâte	b a@ t e
baseball	b e j s b o l
salcia	s a l ch i a
scifo	s ch i f o
declinat	d e k l i n a t
propunerea	p r o p u n e r e@ a
moldovenilor	m o l d o v e n i l o r
motive	m o t i v e
financiare	f i n a n ch i a r e
creat	k r e@ a t
incredibilă	i n k r e d i b i l @
clipul	k l i p u l
regizat	r e dz i z a t
fotograf	f o t o g r a f
bekor	b e k o r
circa	ch i r k a
arhiepiscopia	a r h i e p i s k o p i a
titlu	t i t l u
onorific	o n o r i f i k
făina	f @ i n a
raport	r a p o r t
delegația	d e l e g a ts i a
brătulescu	b r @ t u l e s k u
carantină	k a r a n t i n @
adevărata	a d e v @ r a t a
neprețuită	n e p r e ts u i t @
muncitorul	m u n ch i t o r u l
decedat	d e ch e d a t
îmbrăca	a@ m b r @ k a
retailerii	r i t e j l @ r i j
rezervați	r e z e r v a ts ij
propuneri	p r o p u n e r ij
circulă	ch i r k u l @
linia	l i n i a
tramvaie	t r a m v a j e
autobuze	a u t o b u z e
ascuns	a s k u n s
prânz	p r a@ n z
plătește	p l @ t e sh t e
părinți	p @ r i n ts ij
nebună	n e b u n @
cofetărie	k o f e t @ r i e
dreptatea	d r e p t a t e@ a
cotidianul	k o t i d i a n u l
telegraph	t e l e g r a f
alcătuit	a l k @ t u i t
plângerilor	p l a@ n dz e r i l o r
ciudate	ch i w d a t e
gătit	g @ t i t
zeci	z e ch ij
caută	k a u t @
arma	a r m a
tâmplă	t a@ m p l @
politicianul	p o l i t i ch i a n u l
grele	g r e l e
ritm	r i t m
avorturi	a v o r t u r ij
naștere	n a sh t e r e
italienii	i t a l i e n i j
politici	p o l i t i ch ij
peninsulă	p e n i n s u l @
discutat	d i s k u t a t
informații	i n f o r m a ts i j
divizia	d i v i z i a
private	p r i v a t e
băncii	b @ n ch i j
mondiale	m o n d i a l e
cărțile	k @ r ts i l e
agăța	a g @ ts a
reușim	r e u sh i m
explicație	e k s p l i k a ts i e
teve	t e v e
difuzeze	d i f u z e z e
inși	i n sh ij
plăteam	p l @ t e@ a m
procedeu	p r o ch e d e w
tradițional	t r a d i ts j o n a l
produsul	p r o d u s u l
represiunea	r e p r e s i u n e@ a
distrugerea	d i s t r u dz e r e@ a
persoanei	p e r s o@ a n e j
evidente	e v i d e n t e
dialoguri	d i a l o g u r ij
scandal	s k a n d a l
oriunde	o r i u n d e
sfaturile	s f a t u r i l e
cailor	k a j l o r
lipițani	l i p i ts a n ij
considerabil	k o n s i d e r a b i l
filmezi	f i l m e z ij
isteric	i s t e r i k
audiat	a u d i a t
nume	n u m e
primari	p r i m a r ij
viceprimari	v i ch e p r i m a r ij
beteșuguri	b e t e sh u g u r ij
creeze	k r e e z e
atârn	a t a@ r n
amuză	a m u z @
tudor	t u d o r
fuma	f u m a
iubea	j u b e@ a
detestă	d e t e s t @
snobismul	s n o b i s m u l
bunului	b u n u l u j
simț	s i m ts
performantă	p e r f o r m a n t @
permitem	p e r m i t e m
impertinența	i m p e r t i n e n ts a
dotare	d o t a r e
misiei	m i s i e j
pasiune	p a s i u n e
sindicatul	s i n d i k a t u l
învățământ	a@ n v @ ts @ m a@ n t
înființat	a@ n f i j n ts a t
pensionarilor	p e n s j o n a r i l o r
cânte	k a@ n t e
preferam	p r e f e r a m
olimpiadă	o l i m p i a d @
antena	a n t e n a
direcției	d i r e k ts i e j
urbanism	u r b a n i s m
ciurariu	ch j u r a r j u
caii	k a j i
adoptați	a d o p t a ts ij
olandezi	o l a n d e z ij
instanța	i n s t a n ts a
judecată	zh u d e k a t @
obligatoriu	o b l i g a t o r i w
rămân	r @ m a@ n
riscantă	r i s k a n t @
rugăm	r u g @ m
pomenit	p o m e n i t
preferata	p r e f e r a t a
mierea	m i e r e@ a
mană	m a n @
coloanele	k o l o@ a n e l e
întindeau	a@ n t i n d e@ a u
porțiune	p o r ts i u n e
marchează	m a r k e@ a z @
profitului	p r o f i t u l u j
reinvestit	r e j n v e s t i t
adoptată	a d o p t a t @
prelucra	p r e l u k r a
înregistrare	a@ n r e dz i s t r a r e
oferte	o f e r t e
înghesuiau	a@ n g e s u j a w
participe	p a r t i ch i p e
întâi	a@ n t a@ j
dorian	d o r i a n
tehnician	t e h n i ch i a n
rezistență	r e z i s t e n ts @
cooperat	k o o p e r a t
procurorilor	p r o k u r o r i l o r
antrenamentele	a n t r e n a m e n t e l e
preferatele	p r e f e r a t e l e
principala	p r i n ch i p a l a
asista	a s i s t a
pregătirile	p r e g @ t i r i l e
roadele	r o@ a d e l e
muncii	m u n ch i j
probele	p r o b e l e
înscrierile	a@ n s k r i e r i l e
iunie	j u n i e
filiala	f i l i a l a
paznic	p a z n i k
placă	p l a k @
fostului	f o s t u l u j
aflat	a f l a t
primăria	p r i m @ r i a
mutarea	m u t a r e@ a
micuților	m i k u ts i l o r
mircea	m i r ch e@ a
surprindere	s u r p r i n d e r e
oferta	o f e r t a
așezarea	a sh e z a r e@ a
pasagerilor	p a s a dz e r i l o r
dormi	d o r m i
cramă	k r a m @
urcat	u r k a t
podium	p o d i w m
treacă	t r e@ a k @
jucând	zh u k a@ n d
acumulând	a k u m u l a@ n d
decăzut	d e k @ z u t
afectat	a f e k t a t
ciclul	ch i k l u l
săptămânal	s @ p t @ m a@ n a l
conținutul	k o n ts i n u t u l
antrenamentelor	a n t r e n a m e n t e l o r
regulile	r e g u l i l e
solicitată	s o l i ch i t a t @
urmărirea	u r m @ r i r e@ a
pensionarului	p e n s j o n a r u l u j
luasem	l u a s e m
cuantificabilă	k w a n t i f i k a b i l @
renumerația	r e n u m e r a ts i a
confundă	k o n f u n d @
emisiunile	e m i s i u n i l e
propaganda	p r o p a g a n d a
încercăm	a@ n ch e r k @ m
redescoperim	r e d e s k o p e r i m
luptăm	l u p t @ m
dependentă	d e p e n d e n t @
pictură	p i k t u r @
trageți	t r a dz e ts ij
cursuri	k u r s u r ij
bucătar	b u k @ t a r
frizer	f r i z e r
surselor	s u r s e l o r
citate	ch i t a t e
ipoteze	i p o t e z e
preliminare	p r e l i m i n a r e
angajez	a n g a zh e z
frachețe	f r a k e ts e
cumpătare	k u m p @ t a r e
salvamontistul	s a l v a m o n t i s t u l
karate	k a r a t e
mărite	m @ r i t e
mâncărurile	m a@ n k @ r u r i l e
rafinate	r a f i n a t e
campionatului	k a m p j o n a t u l u j
realitate	r e@ a l i t a t e
reuniunile	r e u n i u n i l e
hleg	h l e g
calendar	k a l e n d a r
prestabilit	p r e s t a b i l i t
infrastructură	i n f r a s t r u k t u r @
trică	t r i k @
adăpostul	a d @ p o s t u l
găzduiește	g @ z d u j e sh t e
pisici	p i s i ch ij
copilă	k o p i l @
europarlamentarii	e u r o p a r l a m e n t a r i j
socialiști	s o ch i a l i sh t ij
respectat	r e s p e k t a t
cerința	ch e r i n ts a
liderilor	l i d e r i l o r
întorc	a@ n t o r k
creștem	k r e sh t e m
acceptăm	a k ch e p t @ m
aglomerația	a g l o m e r a ts i a
spitale	s p i t a l e
pensionară	p e n s j o n a r @
york	j o r k
televiziunea	t e l e v i z i u n e@ a
publică	p u b l i k @
oficială	o f i ch i a l @
susținea	s u s ts i n e@ a
puterii	p u t e r i j
necazurile	n e k a z u r i l e
solicite	s o l i ch i t e
ajutoare	a zh u t o@ a r e
nerambursabile	n e r a m b u r s a b i l e
dureri	d u r e r ij
cumpărate	k u m p @ r a t e
piscină	p i s ch i n @
turul	t u r u l
programat	p r o g r a m a t
baie	b a j e
festivaluri	f e s t i v a l u r ij
rezistați	r e z i s t a ts ij
consumați	k o n s u m a ts ij
fructe	f r u k t e
legume	l e g u m e
miere	m i e r e
reabilitării	r e a b i l i t @ r i j
biletele	b i l e t e l e
bilete	b i l e t e
prezenți	p r e z e n ts ij
manifestare	m a n i f e s t a r e
sătenii	s @ t e n i j
incendiu	i n ch e n d i w
tricolorii	t r i k o l o r i j
întâlni	a@ n t a@ l n i
reprezentativa	r e p r e z e n t a t i v a
ungariei	u n g a r i e j
mulțumește	m u l ts u m e sh t e
tatălui	t a t @ l u j
cert	ch e r t
noiembrie	n o j e m b r i e
argumentele	a r g u m e n t e l e
decisiv	d e ch i s i v
potro	p o t r o
campioana	k a m p j o a n a
estera	e s t e r a
dobre	d o b r e
moara	m o@ a r a
păcăliți	p @ k @ l i ts ij
acțiunea	a k ts i u n e@ a
desfășoare	d e s f @ sh o@ a r e
regiei	r e dz i e j
audierilor	a u d i e r i l o r
înlăturat	a@ n l @ t u r a t
folosesc	f o l o s e s k
instrumentele	i n s t r u m e n t e l e
represive	r e p r e s i v e
posibile	p o s i b i l e
aduceți	a d u ch e ts ij
popoviciu	p o p o v i ch j u
știm	sh t i m
conta	k o n t a
prezența	p r e z e n ts a
anunțate	a n u n ts a t e
plece	p l e ch e
planifica	p l a n i f i k a
sărbători	s @ r b @ t o r ij
precare	p r e k a r e
aranjeze	a r a n zh e z e
camera	k a m e r a
piciorușul	p i ch j o r u sh u l
reproșat	r e p r o sh a t
adesea	a d e s e@ a
distrug	d i s t r u g
găștile	g @ sh t i l e
monteoru	m o n t e o r u
turist	t u r i s t
constănțean	k o n s t @ n ts e@ a n
reșițeni	r e sh i ts e n ij
agitația	a dz i t a ts i a
petrecerilor	p e t r e ch e r i l o r
prefăcut	p r e f @ k u t
pierdere	p i e r d e r e
portalului	p o r t a l u l u j
ample	a m p l e
transformări	t r a n s f o r m @ r ij
crize	k r i z e
atinse	a t i n s e
metastază	m e t a s t a z @
mințile	m i n ts i l e
oravița	o r a v i ts a
ocupă	o k u p @
pleca	p l e k a
milano	m i l a n o
necredința	n e k r e d i n ts a
scene	s ch e n e
violente	v j o l e n t e
jumătăți	zh u m @ t @ ts ij
legată	l e g a t @
raportările	r a p o r t @ r i l e
firmele	f i r m e l e
situează	s i t u e@ a z @
avocatul	a v o k a t u l
surorilor	s u r o r i l o r
andreescu	a n d r e e s k u
contactat	k o n t a k t a t
angajatorii	a n g a zh a t o r i j
gălățeni	g @ l @ ts e n ij
anunță	a n u n ts @
concedieze	k o n ch e d i e z e
colectiv	k o l e k t i v
arate	a r a t e
interesant	i n t e r e s a n t
remarcă	r e m a r k @
căpitanul	k @ p i t a n u l
meciuri	m e ch j u r ij
stadionul	s t a d i o n u l
urziceni	u r z i ch e n ij
intrați	i n t r a ts ij
pistă	p i s t @
odăi	o d @ i
ridica	r i d i k a
anumit	a n u m i t
batem	b a t e m
granzii	g r a n z i j
promis	p r o m i s
activa	a k t i v a
parlament	p a r l a m e n t
discuție	d i s k u ts i e
decidă	d e ch i d @
literatura	l i t e r a t u r a
abundența	a b u n d e n ts a
încălțămintelor	a@ n k @ l ts @ m i n t e l o r
umbră	u m b r @
meseriași	m e s e r i a sh ij
format	f o r m a t
predomina	p r e d o m i n a
petrec	p e t r e k
near	n e@ a r
stoianov	s t o j a n o v
softul	s o f t u l
roțile	r o ts i l e
deplasările	d e p l a s @ r i l e
dragul	d r a g u l
copilului	k o p i l u l u j
cinstită	ch i n s t i t @
profund	p r o f u n d
îngrijorați	a@ n g r i zh o r a ts ij
monumentului	m o n u m e n t u l u j
teorii	t e@ o r i j
ambiția	a m b i ts i a
ajutato	a zh u t a t o
cunoscută	k u n o s k u t @
discursuri	d i s k u r s u r ij
izolate	i z o l a t e
rezolva	r e z o l v a
vânzătoare	v a@ n z @ t o@ a r e
amanet	a m a n e t
reapar	r e a p a r
profil	p r o f i l
oana	o@ a n a
manea	m a n e@ a
adjudecat	a d zh u d e k a t
alegerile	a l e dz e r i l e
absolută	a p s o l u t @
pictorului	p i k t o r u l u j
magie	m a dz i e
transformă	t r a n s f o r m @
culoarea	k u l o@ a r e@ a
așteptă	a sh t e p t @
izolat	i z o l a t
termic	t e r m i k
renovat	r e n o v a t
golănia	g o l @ n i a
pumori	p u m o r i
granița	g r a n i ts a
nepal	n e p a l
tibet	t i b e t
regulă	r e g u l @
rețetă	r e ts e t @
preparatele	p r e p a r a t e l e
rețetele	r e ts e t e l e
prăjituri	p r @ zh i t u r ij
referă	r e f e r @
proprietățile	p r o p r i e t @ ts i l e
obiective	o b i e k t i v e
finanțelor	f i n a n ts e l o r
încheia	a@ n k e j a
artificii	a r t i f i ch i j
temele	t e m e l e
meciului	m e ch j w l u j
panathinaikos	p a n a t i n a j k o s
întreprinzătorul	a@ n t r e p r i n z @ t o r u l
realizeze	r e@ a l i z e z e
hotel	h o t e l
spații	s p a ts i j
divertisment	d i v e r t i s m e n t
străbunicul	s t r @ b u n i k u l
bunicul	b u n i k u l
acrobați	a k r o b a ts ij
reprezentantul	r e p r e z e n t a n t u l
aquabis	a k w a b i s
căilean	k @ j l e@ a n
femeii	f e m e j i
cedo	ch e d o
decretul	d e k r e t u l
revocare	r e v o k a r e
grațierii	g r a ts i e r i j
individuale	i n d i v i d w a l e
revolta	r e v o l t a
organizațiilor	o r g a n i z a ts i j l o r
catolice	k a t o l i ch e
prezentările	p r e z e n t @ r i l e
șotronul	sh o t r o n u l
coarda	k o@ a r d a
actor	a k t o r
talentat	t a l e n t a t
îndrumătoarea	a@ n d r u m @ t o@ a r e@ a
prietena	p r i e t e n a
rodideal	r o d i d e@ a l
membru	m e m b r u
interlope	i n t e r l o p e
aplicate	a p l i k a t e
sechestre	s e k e s t r e
mijloace	m i zh l o@ a ch e
principiu	p r i n ch i p i w
grupări	g r u p @ r ij
trec	t r e k
fazele	f a z e l e
fixe	f i k s e
placa	p l a k a
electronică	e l e k t r o n i k @
meșterul	m e sh t e r u l
tribunalului	t r i b u n a l u l u j
șansă	sh a n s @
profesoarele	p r o f e s o@ a r e l e
humanitas	h u m a n i t a s
căpătat	k @ p @ t a t
nervos	n e r v o s
ridică	r i d i k @
umeri	u m e r ij
minut	m i n u t
debitorii	d e b i t o r i j
protecție	p r o t e k ts i e
abuzuri	a b u z u r ij
băncilor	b @ n ch i l o r
inferior	i n f e r j o r
animalului	a n i m a l u l u j
replica	r e p l i k a
arabilor	a r a b i l o r
miercuri	m i e r k u r ij
khalifah	k a l i f a
bunăvoință	b u n @ v o i n ts @
grigorov	g r i g o r o v
regulamentul	r e g u l a m e n t u l
cupele	k u p e l e
virgil	v i r dz i l
melente	m e l e n t e
clasamentul	k l a s a m e n t u l
superioară	s u p e r j o a r @
ocup	o k u p
camerelor	k a m e r e l o r
comisie	k o m i s i e
cazare	k a z a r e
dispuși	d i s p u sh ij
cheltuiască	k e l t u j a s k @
atâția	a t a@ ts i a
caine	k e j n
lansează	l a n s e@ a z @
scrierile	s k r i e r i l e
restanțe	r e s t a n ts e
acordarea	a k o r d a r e@ a
salariilor	s a l a r i j l o r
tichetelor	t i k e t e l o r
acționarul	a k ts j o n a r u l
companiei	k o m p a n i e j
violența	v j o l e n ts a
limbajului	l i m b a zh u l u j
animalele	a n i m a l e l e
etnie	e t n i e
rromă	r o m @
deranjat	d e r a n zh a t
reacția	r e a k ts i a
discutau	d i s k u t a w
bloca	b l o k a
mizerie	m i z e r i e
așteptat	a sh t e p t a t
lăcașului	l @ k a sh u l u j
neîncăpătoare	n e a@ n k @ p @ t o@ a r e
făcuseră	f @ k u s e r @
civilă	ch i v i l @
gustat	g u s t a t
plin	p l i n
suprafețe	s u p r a f e ts e
cultivate	k u l t i v a t e
viță	v i ts @
nobilă	n o b i l @
primarii	p r i m a r i j
sindicatelor	s i n d i k a t e l o r
proporții	p r o p o r ts i j
avariate	a v a r i a t e
investiția	i n v e s t i ts i a
coreenilor	k o r e e n i l o r
pojarul	p o zh a r u l
scarlatina	s k a r l a t i n a
colecționar	k o l e k ts j o n a r
filatelie	f i l a t e l i e
victime	v i k t i m e
principalii	p r i n ch i p a l i j
pierzători	p i e r z @ t o r ij
înclinația	a@ n k l i n a ts i a
decorațiuni	d e k o r a ts j u n i
brașov	b r a sh o v
laterale	l a t e r a l e
epuizați	e p u j z a ts ij
stresați	s t r e s a ts ij
nemâncați	n e m a@ n k a ts ij
patronatele	p a t r o n a t e l e
sceptice	s ch e p t i ch e
numit	n u m i t
roberto	r o b e r t o
michelletti	m i k e l e t i
conservator	k o n s e r v a t o r
respingerea	r e s p i n dz e r e@ a
peisaje	p e j s a zh e
ansamblu	a n s a m b l u
incertitudini	i n ch e r t i t u d i n ij
neînceperea	n e a@ n ch e p e r e@ a
urmăririi	u r m @ r i r i j
goblenuri	g o b l e n u r ij
decanul	d e k a n u l
ioanei	i o@ a n e j
vișan	v i sh a n
întâmpina	a@ n t a@ m p i n a
plan	p l a n
dori	d o r i
urmezi	u r m e z ij
examen	e g z a m e n
maturitate	m a t u r i t a t e
forfotă	f o r f o t @
domnița	d o m n i ts a
bălașa	b @ l a sh a
italieni	i t a l i e n ij
scoată	s k o@ a t @
maximul	m a k s i m u l
directorului	d i r e k t o r u l u j
pediatrie	p e d i a t r i e
ocupația	o k u p a ts i a
scadă	s k a d @
mâncarea	m a@ n k a r e@ a
speță	s p e ts @
diferită	d i f e r i t @
letoni	l e t o n ij
panait	p a n a i t
sârbu	s a@ r b u
încheiat	a@ n k e j a t
localul	l o k a l u l
studia	s t u d i a
canto	k a n t o
vorbește	v o r b e sh t e
securități	s e k u r i t @ ts ij
școli	sh k o l ij
pregnant	p r e g n a n t
fraze	f r a z e
indicator	i n d i k a t o r
dodon	d o d o n
escatologic	e s k a t o l o dz i k
mulțumim	m u l ts u m i m
corupția	k o r u p ts i a
ocupi	o k u p ij
pirotehnist	p i r o t e h n i s t
nedelcu	n e d e l k u
înmormântarea	a@ n m o r m a@ n t a r e@ a
eforie	e f o r i e
natală	n a t a l @
valea	v a l e@ a
țerovei	ts e r o v e j
comandat	k o m a n d a t
sisteme	s i s t e m e
aceiași	a ch e j a sh ij
învăț	a@ n v @ ts
comunic	k o m u n i k
adaptez	a d a p t e z
situații	s i t u a ts i j
semnată	s e m n a t @
maestrul	m a e s t r u l
cezar	ch e z a r
ghioca	g j o k a
lașitatea	l a sh i t a t e@ a
desemnarea	d e s e m n a r e@ a
gazdă	g a z d @
copenhaga	k o p e n h a g a
indicațiile	i n d i k a ts i j l e
atacată	a t a k a t @
federală	f e d e r a l @
întreg	a@ n t r e g
leii	l e j i
falși	f a l sh ij
criză	k r i z @
înăuntru	a@ n @ u n t r u
continuare	k o n t i n w a r e
performanță	p e r f o r m a n ts @
confiscată	k o n f i s k a t @
muniția	m u n i ts i a
proveniență	p r o v e n i e n ts @
curente	k u r e n t e
facturile	f a k t u r i l e
curent	k u r e n t
prefecturii	p r e f e k t u r i j
aducem	a d u ch e m
pavajul	p a v a zh u l
îngheț	a@ n g e ts
construcțiilor	k o n s t r u k ts i i l o r
revenirea	r e v e n i r e@ a
manuel	m a n u e l
provoacă	p r o v o@ a k @
reacții	r e a k ts i j
antrenorilor	a n t r e n o r i l o r
fotbalul	f o t b a l u l
solicită	s o l i ch i t @
demiterea	d e m i t e r e@ a
lesch	l e sh
penitenciar	p e n i t e n ch i a r
kilograme	k i l o g r a m e
depozit	d e p o z i t
mămici	m @ m i ch ij
petrece	p e t r e ch e
clase	k l a s e
simultan	s i m u l t a n
învățătoarea	a@ n v @ ts @ t o@ a r e@ a
valeria	v a l e r i a
prinzi	p r i n z ij
obținem	o p ts i n e m
concordante	k o n k o r d a n t e
arătau	a r @ t a w
special	s p e ch i a l
motoare	m o t o@ a r e
zburat	z b u r a t
întrebarea	a@ n t r e b a r e@ a
stradali	s t r a d a l ij
scandalul	s k a n d a l u l
oprește	o p r e sh t e
efecte	e f e k t e
nefaste	n e f a s t e
directorii	d i r e k t o r i j
organizaseră	o r g a n i z a s e r @
dintr	d i n t r
intrarea	i n t r a r e@ a
concertul	k o n ch e r t u l
diseară	d i s e@ a r @
ocupăm	o k u p @ m
simptome	s i m p t o m e
gripă	g r i p @
aprecia	a p r e ch i a
delfinilor	d e l f i n i l o r
inter	i n t e r
barcelona	b a r s e l o n a
arsenal	a r s e n a l
chestia	k e s t i a
fratele	f r a t e l e
răzbunare	r @ z b u n a r e
cale	k a l e
controla	k o n t r o l a
depozitate	d e p o z i t a t e
preparate	p r e p a r a t e
alimentele	a l i m e n t e l e
ținute	ts i n u t e
vestimentare	v e s t i m e n t a r e
călătoriile	k @ l @ t o r i j l e
poezii	p o e z i j
predea	p r e d e@ a
posturi	p o s t u r ij
dedicate	d e d i k a t e
muncitorilor	m u n ch i t o r i l o r
obiectele	o b i e k t e l e
rase	r a s e
menționează	m e n ts j o n e@ a z @
tehnică	t e h n i k @
titluri	t i t l u r ij
răpunea	r @ p u n e@ a
edilii	e d i l i j
scuzat	s k u z a t
logodnicele	l o g o d n i ch e l e
suferințe	s u f e r i n ts e
pulmonare	p u l m o n a r e
severe	s e v e r e
demisia	d e m i s i a
forțat	f o r ts a t
persoana	p e r s o@ a n a
respectivă	r e s p e k t i v @
surprinsă	s u r p r i n s @
neatenție	n e a t e n ts i e
criza	k r i z a
afectează	a f e k t e@ a z @
afacerile	a f a ch e r i l e
aprig	a p r i g
disputate	d i s p u t a t e
criminalii	k r i m i n a l i j
liberi	l i b e r ij
secții	s e k ts i j
piardă	p i a r d @
crească	k r e@ a s k @
solicitările	s o l i ch i t @ r i l e
identificării	i d e n t i f i k @ r i j
prinderii	p r i n d e r i j
autorilor	a u t o r i l o r
cazon	k a z o n
sportivilor	s p o r t i v i l o r
consume	k o n s u m e
recurge	r e k u r dz e
suicid	s u j ch i d
întoarcerea	a@ n t o@ a r ch e r e@ a
calvar	k a l v a r
crezut	k r e z u t
dublarea	d u b l a r e@ a
neapărat	n e a p @ r a t
dezavantaj	d e z a v a n t a zh
personajele	p e r s o n a zh e l e
miză	m i z @
momente	m o m e n t e
medicilor	m e d i ch i l o r
ghinionul	g i n j o n u l
adunate	a d u n a t e
echipaje	e k i p a zh e
ajutor	a zh u t o r
transformat	t r a n s f o r m a t
dezbatere	d e z b a t e r e
anderlecht	a n d @ r l e h t
principalele	p r i n ch i p a l e l e
pretendente	p r e t e n d e n t e
calificare	k a l i f i k a r e
europa	e u r o p a
fierți	f i e r ts ij
căutare	k @ u t a r e
organizatorilor	o r g a n i z a t o r i l o r
festivalului	f e s t i v a l u l u j
numărătoarea	n u m @ r @ t o@ a r e@ a
inversă	i n v e r s @
fura	f u r a
cerea	ch e r e@ a
cântăreață	k a@ n t @ r e@ a ts @
simțeau	s i m ts e@ a u
legați	l e g a ts ij
adolescenta	a d o l e s ch e n t a
raliuri	r a l i u r ij
ofițerii	o f i ts e r i j
afecta	a f e k t a
circuitele	ch i r k u i t e l e
micilor	m i ch i l o r
vara	v a r a
vizite	v i z i t e
dormeam	d o r m e@ a m
comenta	k o m e n t a
complicați	k o m p l i k a ts ij
micile	m i ch i l e
șmecherii	sh m e k e r i j
arădeanca	a r @ d e@ a n k a
districtul	d i s t r i k t u l
include	i n k l u d e
cartierul	k a r t i e r u l
queens	k w i n s
dintotdeauna	d i n t o t d e@ a u n a
finalul	f i n a l u l
dramatic	d r a m a t i k
scandinav	s k a n d i n a v
mingi	m i n dz ij
autograful	a u t o g r a f u l
permisul	p e r m i s u l
ocupantele	o k u p a n t e l e
locurilor	l o k u r i l o r
minus	m i n u s
comunală	k o m u n a l @
mătăsari	m @ t @ s a r ij
sesizată	s e s i z a t @
penescu	p e n e s k u
primeau	p r i m e@ a u
avizul	a v i z u l
gospodărire	g o s p o d @ r i r e
apelor	a p e l o r
ingenue	i n dz e n u e
scade	s k a d e
închiderea	a@ n k i d e r e@ a
cifrele	ch i f r e l e
convenite	k o n v e n i t e
singurătatea	s i n g u r @ t a t e@ a
metropolele	m e t r o p o l e l e
scenarista	s ch e n a r i s t a
tralala	t r a l a l a
povară	p o v a r @
onicaș	o n i k a sh
ionescu	j o n e s k u
karzai	k a r z a j
elicopterul	e l i k o p t e r u l
neînțelegeri	n e a@ n ts e l e dz e r ij
neachitate	n e a k i t a t e
returnat	r e t u r n a t
berlin	b e r l i n
copile	k o p i l e
flori	f l o r ij
sesizat	s e s i z a t
practicăm	p r a k t i k @ m
concentrați	k o n ch e n t r a ts ij
implicate	i m p l i k a t e
accidente	a k ch i d e n t e
baclavalele	b a k l a v a l e l e
afectate	a f e k t a t e
ialomița	j a l o m i ts a
dâmbovița	d a@ m b o v i ts a
rare	r a r e
cupluri	k u p l u r ij
românul	r o m a@ n u l
hidrați	h i d r a ts ij
vancea	v a n ch e@ a
hotărască	h o t @ r a s k @
ninu	n i n u
auraș	a u r a sh
brașoveanu	b r a sh o v e@ a n u
gruia	g r u j a
nominalizarea	n o m i n a l i z a r e@ a
postul	p o s t u l
astra	a s t r a
clasament	k l a s a m e n t
plasată	p l a s a t @
promisiuni	p r o m i s i u n ij
sătul	s @ t u l
gane	g a n e
înarmați	a@ n a r m a ts ij
raikkonen	r a j k o n @ n
pluton	p l u t o n
tururi	t u r u r ij
ispas	i s p a s
datele	d a t e l e
problemei	p r o b l e m e j
raportul	r a p o r t u l
împărțea	a@ m p @ r ts e@ a
grupuri	g r u p u r ij
imagina	i m a dz i n a
animale	a n i m a l e
bujar	b u zh a r
nishani	n i sh a n i
precedentul	p r e ch e d e n t u l
portofoliul	p o r t o f o l j u l
revoluția	r e v o l u ts i a
desfășurat	d e s f @ sh u r a t
restricții	r e s t r i k ts i j
circulație	ch i r k u l a ts i e
filtru	f i l t r u
selectiv	s e l e k t i v
consumat	k o n s u m a t
neîncetarea	n e a@ n ch e t a r e@ a
urmării	u r m @ r i j
retras	r e t r a s
plângerea	p l a@ n dz e r e@ a
doris	d o r i s
patiseria	p a t i s e r i a
sibieni	s i b i e n ij
așezată	a sh e z a t @
chiria	k i r i a
metru	m e t r u
pătrat	p @ t r a t
citit	ch i t i t
creațiile	k r e@ a ts i j l e
tata	t a t a
adolescenți	a d o l e s ch e n ts ij
altceva	a l t ch e v a
unirii	u n i r i j
transportat	t r a n s p o r t a t
îngrijiri	a@ n g r i zh i r ij
obișnuia	o b i sh n u j a
versuri	v e r s u r ij
robert	r o b e r t
klein	k l a j n
înjunghiat	a@ n zh u n g i a t
împins	a@ m p i n s
primar	p r i m a r
victimele	v i k t i m e l e
reprezentate	r e p r e z e n t a t e
fugind	f u dz i n d
bandă	b a n d @
universitățile	u n i v e r s i t @ ts i l e
aspect	a s p e k t
concurat	k o n k u r a t
bănuiesc	b @ n u j e s k
spargeri	s p a r dz e r ij
serviciul	s e r v i ch i w l
victoriei	v i k t o r i e j
râdem	r a@ d e m
mințit	m i n ts i t
automobilele	a u t o m o b i l e l e
ambarcațiunile	a m b a r k a ts i u n i l e
dezvoltatori	d e z v o l t a t o r ij
conving	k o n v i n g
interesat	i n t e r e s a t
meniul	m e n i w l
doherty	d o h e r t i
fundamental	f u n d a m e n t a l
celei	ch e l e j
obiectiv	o b i e k t i v
documentația	d o k u m e n t a ts i a
obținerii	o p ts i n e r i j
acordului	a k o r d u l u j
tehnicile	t e h n i ch i l e
controlați	k o n t r o l a ts ij
pandi	p a n d i
operativi	o p e r a t i v ij
drogurile	d r o g u r i l e
proveneau	p r o v e n e@ a u
ascunse	a s k u n s e
promițător	p r o m i ts @ t o r
demis	d e m i s
nedrept	n e d r e p t
condescu	k o n d e s k u
scandalos	s k a n d a l o s
baroc	b a r o k
evidențiat	e v i d e n ts i a t
elementele	e l e m e n t e l e
structurale	s t r u k t u r a l e
fuziunea	f u z i u n e@ a
pământurilor	p @ m a@ n t u r i l o r
agroalimentară	a g r o@ a l i m e n t a r @
terra	t e r a
industria	i n d u s t r i a
deosebire	d e o s e b i r e
precedenți	p r e ch e d e n ts ij
scarlatină	s k a r l a t i n @
etajele	e t a zh e l e
senatori	s e n a t o r ij
liberali	l i b e r a l ij
contesta	k o n t e s t a
ansamblul	a n s a m b l u l
bâlbele	b a@ l b e l e
defensivă	d e f e n s i v @
băgat	b @ g a t
regulamentar	r e g u l a m e n t a r
plasă	p l a s @
spațiul	s p a ts j u l
verde	v e r d e
giratoriu	dz i r a t o r i w
ediție	e d i ts i e
porterii	p o r t e r i j
așteptau	a sh t e p t a w
cald	k a l d
ridicați	r i d i k a ts ij
prietenele	p r i e t e n e l e
unguroaice	u n g u r o@ a i ch e
vroiau	v r o j a w
târziu	t a@ r z i w
sanitar	s a n i t a r
parcării	p a r k @ r i j
autoturismelor	a u t o t u r i s m e l o r
irimescu	i r i m e s k u
nicola	n i k o l a
impresionante	i m p r e s j o n a n t e
investigația	i n v e s t i g a ts i a
extinsă	e k s t i n s @
google	g u g l @
stricte	s t r i k t e
investițiile	i n v e s t i ts i i l e
străine	s t r @ i n e
realizat	r e@ a l i z a t
cilindru	ch i l i n d r u
conține	k o n ts i n e
burete	b u r e t e
stațiile	s t a ts i j l e
transformare	t r a n s f o r m a r e
conduse	k o n d u s e
asemănătoare	a s e m @ n @ t o@ a r e
washington	w a sh i n g t o n
melbourne	m e l b o r n
enervant	e n e r v a n t
sighet	s i g e t
gutâi	g u t a@ j
acționează	a k ts j o n e@ a z @
prinderea	p r i n d e r e@ a
vali	v a l i
năstase	n @ s t a s e
forța	f o r ts a
cântărește	k a@ n t @ r e sh t e
arcelormittal	a r ch e l o r m i t a l
groapa	g r o@ a p a
semnalizată	s e m n a l i z a t @
firmei	f i r m e j
next	n e k s t
taxi	t a k s i
citroen	s i t r o e n
așteptam	a sh t e p t a m
sofisticat	s o f i s t i k a t
plimbările	p l i m b @ r i l e
munte	m u n t e
weekendurile	u e e k e n d u r i l e
libere	l i b e r e
mitchell	m i ch e l
revine	r e v i n e
gazon	g a z o n
dvduri	d i v i d i u r ij
norvegianul	n o r v e dz i a n u l
remarcat	r e m a r k a t
argentinienii	a r dz e n t i n i e n i j
cfrului	ch e f e r e u l u j
subliniind	s u b l i n i i n d
banul	b a n u l
vândute	v a@ n d u t e
răutatea	r @ u t a t e@ a
prostia	p r o s t i a
vâneze	v a@ n e z e
fault	f a w l t
delfinii	d e l f i n i j
cercetată	ch e r ch e t a t @
influența	i n f l u e n ts a
băuturilor	b @ u t u r i l o r
alcoolice	a l k o o l i ch e
ocupație	o k u p a ts i e
chirie	k i r i e
roland	r o l a n d
garros	g a r o s
coboară	k o b o@ a r @
șoferului	sh o f e r u l u j
complici	k o m p l i ch ij
fabricare	f a b r i k a r e
cardurilor	k a r d u r i l o r
grade	g r a d e
celsius	ch e l s i u s
conductorul	k o n d u k t o r u l
observat	o p s e r v a t
interzicea	i n t e r z i ch e@ a
ianis	j a n i s
regulat	r e g u l a t
exerciții	e g z e r ch i ts i j
teste	t e s t e
armament	a r m a m e n t
țină	ts i n @
unirea	u n i r e@ a
sincer	s i n ch e r
pronosticuri	p r o n o s t i k u r ij
recomandă	r e k o m a n d @
periodică	p e r j o d i k @
dușului	d u sh u l u j
suporterilor	s u p o r t e r i l o r
rural	r u r a l
cursurile	k u r s u r i l e
gimnaziale	dz i m n a z i a l e
îngrașă	a@ n g r a sh @
renovate	r e n o v a t e
slujbă	s l u zh b @
adună	a d u n @
mesei	m e s e j
sălile	s @ l i l e
curățate	k u r @ ts a t e
dezinfectate	d e z i n f e k t a t e
indemnizațiile	i n d e m n i z a ts i j l e
aleagă	a l e@ a g @
ieftină	j e f t i n @
glicemia	g l i ch e m i a
conservatoristă	k o n s e r v a t o r i s t @
ecuadorul	e k u a d o r u l
columbia	k o l u m b i a
contact	k o n t a k t
diplomatic	d i p l o m a t i k
băteam	b @ t e@ a m
rapidiști	r a p i d i sh t ij
legitimă	l e dz i t i m @
autohton	a u t o h t o n
drepturi	d r e p t u r ij
conferite	k o n f e r i t e
cercetările	ch e r ch e t @ r i l e
rețete	r e ts e t e
zburdalnici	z b u r d a l n i ch ij
greșim	g r e sh i m
portar	p o r t a r
haris	h a r i s
înainta	a@ n a i n t a
cerere	ch e r e r e
parterele	p a r t e r e l e
viziru	v i z i r u
lovească	l o v e@ a s k @
înregistrarea	a@ n r e dz i s t r a r e@ a
cerem	ch e r e m
serioși	s e r i o sh ij
pozitivi	p o z i t i v ij
finalizare	f i n a l i z a r e
prejudiciul	p r e zh u d i ch i w l
despărțirea	d e s p @ r ts i r e@ a
andreea	a n d r e a
cabral	k a b r a l
fenerbahce	f e n e r b a h ch e
fronturile	f r o n t u r i l e
senatorul	s e n a t o r u l
ceahlăul	ch e@ a h l @ u l
beneficiat	b e n e f i ch i a t
finalizată	f i n a l i z a t @
melodiile	m e l o d i j l e
rock	r o k
telenovelele	t e l e n o v e l e l e
apară	a p a r @
piersic	p i e r s i k
iagnov	j a g n o v
constatările	k o n s t a t @ r i l e
adoptat	a d o p t a t
stil	s t i l
carnea	k a r n e@ a
schimbările	s k i m b @ r i l e
fundamentale	f u n d a m e n t a l e
razii	r a z i j
pozat	p o z a t
răsfățat	r @ s f @ ts a t
activității	a k t i v i t @ ts i j
instructorilor	i n s t r u k t o r i l o r
climatizare	k l i m a t i z a r e
arhitectură	a r h i t e k t u r @
suspensii	s u s p e n s i j
inovatoare	i n o v a t o@ a r e
brazilienii	b r a z i l i e n i j
leandro	l e a n d r o
silva	s i l v a
afonso	a f o n s o
alves	a l v e s
grandomania	g r a n d o m a n i a
poluatorul	p o l w a t o r u l
executa	e g z e k u t a
depoluare	d e p o l w a r e
începute	a@ n ch e p u t e
arsuri	a r s u r ij
ușoare	u sh o@ a r e
mâini	m a@ j n ij
toader	t o@ a d e r
acelorași	a ch e l o r a sh ij
tehnologii	t e h n o l o dz i j
catedră	k a t e d r @
animația	a n i m a ts i a
circulației	ch i r k u l a ts i e j
berci	b e r ch ij
nefericită	n e f e r i ch i t @
mândru	m a@ n d r u
accesibilă	a k ch e s i b i l @
semnal	s e m n a l
mobil	m o b i l
bătrânii	b @ t r a@ n i j
restanțieri	r e s t a n ts i e r ij
promoția	p r o m o ts i a
rivali	r i v a l ij
puternici	p u t e r n i ch ij
reușesc	r e u sh e s k
mobilizez	m o b i l i z e z
responsabilizez	r e s p o n s a b i l i z e z
kaiaciștilor	k a j a ch i sh t i l o r
râurile	r a@ w r i l e
drau	d r a w
isel	i s e l
virginia	v i r dz i n i a
cireși	ch i r e sh ij
vișini	v i sh i n ij
nuci	n u ch ij
gutui	g u t u j
cartierele	k a r t i e r e l e
berceni	b e r ch e n ij
procedură	p r o ch e d u r @
alătură	a l @ t u r @
politeții	p o l i t e ts i j
manifestate	m a n i f e s t a t e
taximetriști	t a k s i m e t r i sh t ij
inconștient	i n k o n sh t i e n t
ruptură	r u p t u r @
musculară	m u s k u l a r @
vehiculat	v e h i k u l a t
vederile	v e d e r i l e
naționalei	n a ts j o n a l e j
aflau	a f l a w
torje	t o r zh e
cârstea	k a@ r s t e@ a
recuperare	r e k u p e r a r e
fizică	f i z i k @
confiscate	k o n f i s k a t e
distruse	d i s t r u s e
castelului	k a s t e l u l u j
incendiară	i n ch e n d i a r @
probă	p r o b @
evreii	e v r e j i
uzată	u z a t @
negociabil	n e g o ch i a b i l
râuri	r a@ w r ij
curs	k u r s
vire	v i r e
nordul	n o r d u l
modelul	m o d e l u l
diversitatea	d i v e r s i t a t e@ a
etnică	e t n i k @
volum	v o l u m
istoricește	i s t o r i ch e sh t e
mire	m i r e
borcanele	b o r k a n e l e
închidem	a@ n k i d e m
capac	k a p a k
ermetic	e r m e t i k
pivniță	p i v n i ts @
levente	l e v e n t e
borșoș	b o r sh o sh
chioșc	k j o sh k
filmările	f i l m @ r i l e
serial	s e r i a l
crapă	k r a p @
casele	k a s e l e
liniște	l i n i sh t e
încurajați	a@ n k u r a zh a ts ij
hărțuiți	h @ r ts u i ts ij
extraordinar	e k s t r a o r d i n a r
spatele	s p a t e l e
demers	d e m e r s
intervenții	i n t e r v e n ts i j
reparații	r e p a r a ts i j
înlocuirea	a@ n l o k u i r e@ a
cărămizii	k @ r @ m i z i j
nevada	n e v a d a
termopane	t e r m o p a n e
spaniolii	s p a n i o l i j
arunce	a r u n ch e
asumarea	a s u m a r e@ a
răspunderii	r @ s p u n d e r i j
rupe	r u p e
orlando	o r l a n d o
sticle	s t i k l e
scrumiere	s k r u m i e r e
mese	m e s e
replicat	r e p l i k a t
reprezentanta	r e p r e z e n t a n t a
laviniei	l a v i n i e j
șandru	sh a n d r u
cluburi	k l u b u r ij
electra	e l e k t r a
rece	r e ch e
massmedia	m a s m e d i a
subiectul	s u b i e k t u l
jucătorului	zh u k @ t o r u l u j
sponsori	s p o n s o r ij
comisarul	k o m i s a r u l
iacobescu	j a k o b e s k u
costești	k o s t e sh t ij
hostess	h o w s t e s
doctori	d o k t o r ij
asumat	a s u m a t
management	m a n a dz e m e n t
amână	a m a@ n @
lunile	l u n i l e
salatele	s a l a t e l e
turcești	t u r ch e sh t ij
părere	p @ r e r e
seril	s e r i l
talpălaru	t a l p @ l a r u
inspectorul	i n s p e k t o r u l
așteptând	a sh t e p t a@ n d
cuminți	k u m i n ts ij
tarabele	t a r a b e l e
deschise	d e s k i s e
femeie	f e m e j e
unitatea	u n i t a t e@ a
partida	p a r t i d a
emil	e m i l
alexandrescu	a l e k s a n d r e s k u
opinat	o p i n a t
oradea	o r a d e@ a
fracturate	f r a k t u r a t e
petrecerea	p e t r e ch e r e@ a
seven	s e v @ n
centrală	ch e n t r a l @
ansamblului	a n s a m b l u l u j
arhitectural	a r h i t e k t u r a l
datează	d a t e@ a z @
secolului	s e k o l u l u j
drogați	d r o g a ts ij
tragic	t r a dz i k
romgaz	r o m g a z
stoichiță	s t o j k i ts @
alterată	a l t e r a t @
proprie	p r o p r i e
povestit	p o v e s t i t
platforma	p l a t f o r m a
monitorizează	m o n i t o r i z e@ a z @
radiațiilor	r a d i a ts i j l o r
solare	s o l a r e
arhitecturii	a r h i t e k t u r i j
dâmboviței	d a@ m b o v i ts e j
trend	t r e n d
deschidere	d e s k i d e r e
parcul	p a r k u l
portul	p o r t u l
beneficiarilor	b e n e f i ch i a r i l o r
lipsește	l i p s e sh t e
ecrane	e k r a n e
perindau	p e r i n d a w
miniștri	m i n i sh t r i
șefi	sh e f ij
dispune	d i s p u n e
curățenie	k u r @ ts e n i e
politicoși	p o l i t i k o sh ij
polițiștilor	p o l i ts i sh t i l o r
sancționat	s a n k ts j o n a t
muncită	m u n ch i t @
prejudiciului	p r e zh u d i ch i w l u j
returul	r e t u r u l
mijlocașul	m i zh l o k a sh u l
transferat	t r a n s f e r a t
formația	f o r m a ts i a
pregătită	p r e g @ t i t @
profesorii	p r o f e s o r i j
dubarbier	d u b a r b i e r
expediază	e k s p e d i a z @
weekend	u e e k e n d
estetică	e s t e t i k @
jalnic	zh a l n i k
volumul	v o l u m u l
pictori	p i k t o r ij
răsuflat	r @ s u f l a t
ușurați	u sh u r a ts ij
formezi	f o r m e z ij
îndemânarea	a@ n d e m a@ n a r e@ a
crescători	k r e s k @ t o r ij
județ	zh u d e ts
depus	d e p u s
dosarele	d o s a r e l e
subvenție	s u b v e n ts i e
amalgam	a m a l g a m
punem	p u n e m
chitanțe	k i t a n ts e
sumele	s u m e l e
șterse	sh t e r s e
cifre	ch i f r e
eforturile	e f o r t u r i l e
meritat	m e r i t a t
trudește	t r u d e sh t e
calificările	k a l i f i k @ r i l e
pole	p o l
position	p o z i sh @ n
includerii	i n k l u d e r i j
gazelor	g a z e l o r
solistul	s o l i s t u l
lovitura	l o v i t u r a
coaliție	k o a l i ts i e
infracțiunile	i n f r a k ts i u n i l e
nepedepsite	n e p e d e p s i t e
realizez	r e@ a l i z e z
cristi	k r i s t i
tănase	t @ n a s e
maximum	m a k s i m u m
repriză	r e p r i z @
aiurea	a j u r e@ a
administrarea	a d m i n i s t r a r e@ a
multivitaminelor	m u l t i v i t a m i n e l o r
hipervitaminozelor	h i p e r v i t a m i n o z e l o r
unicul	u n i k u l
extra	e k s t r a
tehnicieni	t e h n i ch i e n ij
expert	e k s p e r t
sovietic	s o v i e t i k
mureș	m u r e sh
dumbrăveni	d u m b r @ v e n ij
birouri	b i r o u r ij
certitudine	ch e r t i t u d i n e
secrete	s e k r e t e
laptele	l a p t e l e
comunicarea	k o m u n i k a r e@ a
grădiniță	g r @ d i n i ts @
taurii	t a w r i j
existau	e g z i s t a w
furnizarea	f u r n i z a r e@ a
apei	a p e j
sistată	s i s t a t @
decanatul	d e k a n a t u l
facultăților	f a k u l t @ ts i l o r
reprezentativă	r e p r e z e n t a t i v @
regimul	r e dz i m u l
turismul	t u r i s m u l
pierzi	p i e r z ij
lupt	l u p t
securitate	s e k u r i t a t e
rechizite	r e k i z i t e
marfa	m a r f a
suporterii	s u p o r t e r i j
adevărați	a d e v @ r a ts ij
scriam	s k r i a m
fetelor	f e t e l o r
cliente	k l i e n t e
profesionist	p r o f e s j o n i s t
criminalului	k r i m i n a l u l u j
rupea	r u p e@ a
arunca	a r u n k a
pastilele	p a s t i l e l e
prescrise	p r e s k r i s e
presa	p r e s a
fotografiile	f o t o g r a f i j l e
administratorul	a d m i n i s t r a t o r u l
instige	i n s t i dz e
lansare	l a n s a r e
paracetamol	p a r a ch e t a m o l
aspirină	a s p i r i n @
singurele	s i n g u r e l e
tablete	t a b l e t e
existente	e g z i s t e n t e
dulăpioarele	d u l @ p j o@ a r e l e
sportivul	s p o r t i v u l
locuiește	l o k u j e sh t e
experimentat	e k s p e r i m e n t a t
maftei	m a f t e j
canada	k a n a d a
întocmit	a@ n t o k m i t
dezvăluie	d e z v @ l u j e
dulcețurile	d u l ch e ts u r i l e
pregătite	p r e g @ t i t e
sezonul	s e z o n u l
negociază	n e g o ch i a z @
reprezinte	r e p r e z i n t e
cosmin	k o s m i n
deplasarea	d e p l a s a r e@ a
skateul	s k e j t u l
translator	t r a n s l a t o r
copiezi	k o p i e z ij
stănculescu	s t @ n k u l e s k u
apelat	a p e l a t
absolvă	a p s o l v @
responsabilitatea	r e s p o n s a b i l i t a t e@ a
disciplină	d i s ch i p l i n @
vinovații	v i n o v a ts i j
dosarul	d o s a r u l
parchetul	p a r k e t u l
autoturismul	a u t o t u r i s m u l
picior	p i ch j o r
personajului	p e r s o n a zh u l u j
mișu	m i sh u
felecan	f e l e k a n
dulciurilor	d u l ch i w r i l o r
delicatesele	d e l i k a t e s e l e
însiropate	a@ n s i r o p a t e
bacalbașa	b a k a l b a sh a
brașovul	b r a sh o v u l
lider	l i d e r
nașteri	n a sh t e r ij
economic	e k o n o m i k
vătămare	v @ t @ m a r e
corporală	k o r p o r a l @
culpă	k u l p @
scontate	s k o n t a t e
mint	m i n t
viceversa	v i ch e v e r s a
invalid	i n v a l i d
mătușa	m @ t u sh a
paraschiva	p a r a s k i v a
flăcău	f l @ k @ u
stătut	s t @ t u t
stan	s t a n
flăcăul	f l @ k @ u l
străini	s t r @ i n ij
cunoască	k u n o@ a s k @
tată	t a t @
mamă	m a m @
rudă	r u d @
ocrotească	o k r o t e@ a s k @
ajute	a zh u t e
străin	s t r @ i n
găsea	g @ s e@ a
ușile	u sh i l e
oploșit	o p l o sh i t
credință	k r e d i n ts @
sclipuit	s k l i p u i t
văcușoară	v @ k u sh o@ a r @
înjghebat	a@ n zh g e b a t
căsuță	k @ s u ts @
statornicit	s t a t o r n i ch i t
trăgânduse	t r @ g a@ n d u s e
muncind	m u n ch i n d
piatra	p i a t r a
mușchi	m u sh k i
avere	a v e r e
bunicică	b u n i ch i k @
pietre	p i e t r e
prindea	p r i n d e@ a
somnul	s o m n u l
harnic	h a r n i k
dintro	d i n t r o
carul	k a r u l
treburile	t r e b u r i l e
punea	p u n e@ a
vitișoare	v i t i sh o@ a r e
întindă	a@ n t i n d @
prinsese	p r i n s e s e
vatră	v a t r @
alerga	a l e r g a
muncea	m u n ch e@ a
încăleca	a@ n k @ l e k a
șapoi	sh a p o j
urâtul	u r a@ t u l
uita	u j t a
givorniță	dz i v o r n i ts @
apuce	a p u ch e
cântecului	k a@ n t e k u l u j
flăcăului	f l @ k @ u l u j
însoare	a@ n s o@ a r e
pătimit	p @ t i m i t
amâna	a m a@ n a
poznașă	p o z n a sh @
trebușoară	t r e b u sh o@ a r @
gingașă	dz i n g a sh @
privințe	p r i v i n ts e
numea	n u m e@ a
femeiai	f e m e j a j
fund	f u n d
ferească	f e r e@ a s k @
leneșă	l e n e sh @
mârșavă	m a@ r sh a v @
risipitoare	r i s i p i t o@ a r e
năstrușnicii	n @ s t r u sh n i ch i j
încât	a@ n k a@ t
destui	d e s t u j
ticăiți	t i k @ i ts j
chitcăiți	k i t k @ i ts j
trezinduse	t r z i n d u s e
nebunii	n e b u n i j
cumpene	k u m p e n e
însura	a@ n s u r a
primăvară	p r i m @ v a r @
burlăcia	b u r l @ ch i a
însurătoarea	a@ n s u r @ t o@ a r e@ a
însoară	a@ n s o@ a r @
babă	b a b @
dracu	d r a k u
prietenii	p r i e t e n i j
câtus	k a@ t u s
prefăcute	p r e f @ k u t e
iscoditoare	i s k o d i t o@ a r e
dintrînsul	d i n t r a@ n s u l
răpune	r @ p u n e
trăgeau	t r @ dz e@ a u
nădejdea	n @ d e zh d e@ a
ginere	dz i n e r e
chitit	k i t i t
lehămetinduse	l e h @ m i t a@ n d u s e
burduful	b u r d u f u l
înjugă	a@ n zh u g @
boii	b o i i
mijea	m i zh e@ a
ziuă	z i w @
tăiat	t @ j a t
încărcat	a@ n k @ r k a t
cetluit	ch e t l u i t
pânor	p a@ n o r
bucățică	b u k @ ts i k @
teșitura	t e sh i t u r a
lighioaie	l i g i o@ a j e
mămăliga	m @ m @ l i g a
teșitură	t e sh i t u r @
prânzișor	p r a@ n z i sh o r
stârnit	s t a@ r n i t
vifor	v i f o r
cumplit	k u m p l i t
lapoviță	l a p o v i ts @
vedeai	v e d e@ a i
mânia	m a@ n i a
scoți	s k o ts ij
voind	v o i n d
slugilor	s l u dz i l o r
pretutindene	p r e t u t i n d e n e
uscat	u s k a t
vâre	v a@ r e
vrajbă	v r a zh b @
pacoste	p a k o s t e
împrăștiat	a@ m p r @ sh t i a t
fulgerul	f u l dz e r u l
păduri	p @ d u r ij
trebălui	t r e b @ l u i
vrun	v r u n
chinuiască	k i n u j a s k @
altuia	a l t u j a
rupă	r u p @
schilodească	s k i l o d e@ a s k @
ucide	u ch i d e
bazaconii	b a z a k o n i j
năzbutii	n @ z b u t i j
iscodește	i s k o d e sh t e
vrăjește	v r @ zh e sh t e
isprăvit	i s p r @ v i t
luntre	l u n t r e
codița	k o d i ts a
bârligată	b a@ r l i g a t @
umbla	u m b l a
cercând	ch e r k a@ n d
colea	k o l e@ a
înspre	a@ n s p r e
pârtie	p a@ r t i e
tiptil	t i p t i l
încărcase	a@ n k @ r k a s e
lemnele	l e m n e l e
ieșise	j e sh i s e
izbutit	i z b u t i t
crâșcă	k r a@ sh k @
măsele	m @ s e l e
îngrijit	a@ n g r i zh i t
obraz	o b r a z
înfățișeze	a@ n f @ ts i sh e z e
buimac	b u j m a k
hămesit	h @ m e s i t
foame	f o@ a m e
umblet	u m b l e t
posomorât	p o s o m o r a@ t
halește	h a l e sh t e
nemaiavând	n e m a j a v a@ n d
coada	k o@ a d a
stăpânu	s t @ p a@ n u
ispravă	i s p r a v @
suflete	s u f l e t e
arvonit	a r v o n i t
dăți	d @ ts ij
solia	s o l i a
stăpâne	s t @ p a@ n e
rușinat	r u sh i n a t
dimpotrivă	d i m p o t r i v @
deam	d e@ a m
mațele	m a ts e l e
întunecimea	a@ n t u n e ch i m e@ a
voastră	v o@ a s t r @
zmârdoare	z m a@ r d o@ a r e
urâcioasă	u r a@ ch j o@ a s @
boțul	b o ts u l
păzești	p @ z e sh t ij
muritorii	m u r i t o r i ij
dară	d a r @
zisai	z i s a j
osteneală	o s t e n e@ a l @
afli	a f l ij
nădejde	n @ d e zh d e
căți	k @ ts ij
acuș	a k u sh
leacul	l e@ a k u l
iați	j a ts ij
tălpășița	t @ l p @ sh i ts a
pornesc	p o r n e s k
raită	r a j t @
straie	s t r a j e
nemțești	n e m ts e sh t ij
zgribulind	z g r i b u l i n d
ceaunul	ch e@ a u n u l
mestece	m e s t e ch e
reped	r e p e d
altăceva	a l t @ ch e v a
acățăra	a k @ ts @ r a
stâlpul	s t a@ l p u l
porții	p o r ts i j
teama	t e@ a m a
țibă	ts i b @
hormuz	h o r m u z
balan	b a l a n
zurzan	z u r z a n
dațivăn	d a ts i v @ n
lături	l @ t u r ij
cotarle	k o t a r l e
țică	ts i k @
cauți	k a u ts ij
bădică	b @ d i k @
sărman	s @ r m a n
păscut	p @ s k u t
gâștele	g a@ sh t e l e
spui	s p u j
vrabiai	v r a b j a j
straiele	s t r a j e l e
pocite	p o ch i t e
arăți	a r @ ts ij
sfrijit	s f r i zh i t
închircit	a@ n k i r ch i t
deunăzi	d e u n @ z ij
umblând	u m b l a@ n d
dealde	d e@ a l d e
chipos	k i p o s
antereu	a n t e r e u
canavață	k a n a v a ts @
ținea	ts i n e@ a
numan	n u m a n
nădragi	n @ d r a dz ij
anglie	a n g l i e
petice	p e t i ch e
nădragii	n @ d r a dz i j
alăturea	a l @ t u r e@ a
trecea	t r e ch e@ a
pieptănat	p i e p t @ n a t
peticele	p e t i ch e l e
desară	d e s a r @
parcăl	p a r k @ l
ferfenițos	f e r f e n i ts o s
culegea	k u l e dz e@ a
boarfele	b o@ a r f e l e
chirică	k i r i k @
parpalecule	p a r p a l e k u l e
botezat	b o t e z a t
nănaș	n @ n a sh
nimerit	n i m e r i t
vrăbioi	v r @ b j o j
bade	b a d e
hoituri	h o j t u r ij
cheme	k e m e
dumneata	d u m n e@ a t a
ipate	i p a t e
plesnit	p l e s n i t
pălărie	p @ l @ r i e
comoară	k o m o@ a r @
mărunțel	m @ r u n ts e l
lată	l a t @
îmbujorată	a@ m b u zh o r a t @
crăcănată	k r @ k @ n a t @
măciulie	m @ ch j u l i e
limpezeală	l i m p e z e@ a l @
gălbeneală	g @ l b e n e@ a l @
huduleț	h u d u l e ts
zâmbi	z a@ m b i
deoi	d e@ o j
hrincă	h r i n k @
ghicește	g i ch e sh t e
vatra	v a t r a
pirostiile	p i r o s t i i l e
culeșerul	k u l e sh e r u l
melesteul	m e l e s t e u l
tocmești	t o k m e sh t ij
tocmesc	t o k m e s k
purtat	p u r t a t
împlini	a@ m p l i n i
dumitale	d u m i t a l e
bărăni	b @ r @ n i
naibi	n a j b ij
țioi	ts j o j
măsoarăi	m @ s o@ a r @ j
îmblăciul	a@ m b l @ ch i u l
deslușit	d e s l u sh i t
undei	u n d e j
mânie	m a@ n i e
aceastați	a k e@ a s t a ts ij
ciotul	ch j o t u l
calul	k a l u l
gard	g a r d
împăca	a@ m p @ k a
isteț	i s t e ts
sameni	s a m e n ij
știind	sh t i i n d
lucrul	l u k r u l
trebile	t r e b i l e
leoi	l e@ o j
stea	s t e@ a
frunte	f r u n t e
binear	b i n e@ a r
dacar	d a k a r
dinainte	d i n a i n t e
sărite	s @ r i t e
răbuș	r @ b u sh
bănui	b @ n u i
vasăzică	v a s @ z i k @
bulughine	b u l u g i n e
mujdei	m u zh d e j
colb	k o l b
băiatul	b @ j a t u l
ciobănește	ch j o b @ n e sh t e
îmbucă	a@ m b u k @
măsa	m @ s a
îndemna	a@ n d e m n a
uitase	u j t a s e
huzurea	h u z u r e@ a
tocmit	t o k m i t
norocul	n o r o k u l
curgea	k u r dz e@ a
gârlă	g a@ r l @
garduri	g a r d u r ij
streșinite	s t r e sh i n i t e
răzbate	r @ z b a t e
ocoale	o k o@ a l e
vaci	v a ch ij
perdea	p e r d e@ a
poieți	p o j e ts ij
păsări	p @ s @ r ij
cotețe	k o t e ts e
porci	p o r ch ij
sâsâiac	s a@ s a@ j a k
păpușoi	p @ p u sh o j
hambare	h a m b a r e
palme	p a l m e
îmbogățise	a@ m b o g @ ts i s e
însutit	a@ n s u t i t
înmiit	a@ n m i i t
văzuse	v @ z u s e
trecură	t r e k u r @
bănuiești	b @ n u j e sh t ij
însori	a@ n s o r i
poimâine	p o j m a@ j n e
trezi	t r e z i
îmbătrânit	a@ m b @ t r a@ n i t
urmaș	u r m a sh
însor	a@ n s o r
soarele	s o@ a r e l e
tânăr	t a@ n @ r
lasămă	l a s @ m @
pârdalnicul	p a@ r d a l n i k u l
speria	s p e r i a
nevasta	n e v a s t a
slavă	s l a v @
dodii	d o d i j
semănături	s e m @ n @ t u r ij
trebuincioase	t r e b u i n ch j o@ a s e
colaci	k o l a ch ij
nuntă	n u n t @
cumătrie	k u m @ t r i e
lanuri	l a n u r ij
stăpânul	s t @ p a@ n u l
moșiei	m o sh i e j
girezi	dz i r e z ij
grâul	g r a@ u l
semănat	s e m @ n a t
ostenicioasă	o s t e n i ch j o@ a s @
primești	p r i m e sh t ij
secera	s e ch e r a
strânge	s t r a@ n dz e
sarcini	s a r ch i n ij
cunoști	k u n o sh t ij
ascultămă	a s k u l t @ m @
iniman	i n i m a n
dinți	d i n ts ij
cucoane	k u k o@ a n e
secerători	s e ch e r @ t o r ij
suferi	s u f e r i
întârziere	a@ n t a@ r z i e r e
gospodăresc	g o s p o d @ r e s k
bizuiești	b i z u j e sh t j
câtea	k a@ t e@ a
hurta	h u r t a
băietan	b @ j e t a n
omule	o m u l e
înadins	a@ n a d i n s
șuguiești	sh u g u j e sh t ij
mântuie	m a@ n t u j e
treabăi	t r e@ a b @ j
împăcarea	a@ m p @ k a r e@ a
groaza	g r o@ a z a
câtui	k a@ t u j
trebuitoare	t r e b u i t o@ a r e
haidem	h a j d e m
înseratelea	a@ n s e r a t e l e@ a
culcăte	k u l k @ t e
odihnește	o d i h n e sh t e
grija	g r i zh a
obosit	o b o s i t
lăsă	l @ s @
iarbă	j a r b @
drăcimea	d r @ ch i m e@ a
câmp	k a@ m p
secerau	s e ch e r a w
legau	l e g a w
snopi	s n o p ij
făceau	f @ ch e@ a u
clăi	k l @ i
suflau	s u f l a w
nările	n @ r i l e
usuce	u s u ch e
cărau	k @ r a w
claca	k l a k a
zori	z o r ij
mântuit	m a@ n t u i t
grâului	g r a@ u l u j
gireadă	dz i r e@ a d @
așezate	a sh e z a t e
dealului	d e@ a l u l u j
nicăieri	n i k @ j e r ij
suit	s u i t
părul	p @ r u l
capului	k a p u l u j
dormind	d o r m i n d
feciorii	f e ch j o r i j
boierești	b o j e r e sh t ij
sculară	s k u l a r @
veniră	v e n i r @
văzură	v @ z u r @
cuprinse	k u p r i n s e
fuga	f u g a
vestiră	v e s t i r @
azvârle	a z v a@ r l e
auzise	a u z i s e
fiți	f i ts ij
încins	a@ n ch i n s
gireada	dz i r e@ a d a
subsuori	s u b s u o r ij
crezând	k r e z a@ n d
calicește	k a l i ch e sh t e
necaz	n e k a z
binișorul	b i n i sh o r u l
plugăria	p l u g @ r i a
samăn	s a m @ n
alaltăieri	a l a l t @ j e r ij
seamă	s e@ a m @
ducețivă	d u ch e ts i v @
treierase	t r e j e r a s e
vânturase	v a@ n t u r a s e
măcinase	m @ ch i n a s e
pusese	p u s e s e
puso	p u s o
aceștias	a ch e s t e@ a s
punei	p u n e j
chimir	k i m i r
molcum	m o l k u m
cadă	k a d @
îngreuiat	a@ n g r e u j a t
gospodăria	g o s p o d @ r i a
pesteo	p e s t e@ o
lehamete	l e h a m e t e
teoi	t e@ o j
drăguț	d r @ g u ts
călare	k @ l a r e
laud	l a w d
măruntaiele	m @ r u n t a j e l e
dintrînsele	d i n t r a@ n s e l e
faceo	f a ch e@ o
teapa	t e@ a p a
nasul	n a s u l
vrednic	v r e d n i k
minți	m i n ts ij
staroste	s t a r o s t e
îndreptat	a@ n d r e p t a t
berechet	b e r e k e t
cămi	k @ m ij
nălucă	n @ l u k @
priit	p r i i t
horă	h o r @
deoparte	d e@ o p a r t e
lângo	l a@ n g o
piciorul	p i ch j o r u l
zace	z a ch e
chitito	k i t i t o
fură	f u r @
sfinții	s f i n ts i j
băieților	b @ j e ts i l o r
hlizea	h l i z e@ a
chitește	k i t e sh t e
hora	h o r a
călca	k @ l k a
flăcăilor	f l @ k @ i l o r
tropai	t r o p a j
ropai	r o p a j
aprind	a p r i n d
călcâiele	k @ l k a@ j e l e
spiridușul	s p i r i d u sh u l
aburit	a b u r i t
păcatele	p @ k a t e l e
teau	t e@ a w
hazulie	h a z u l i e
fermecat	f e r m e k a t
asculți	a s k u l ts ij
sfătuiesc	s f @ t u j e s k
focui	f o k u j
hazuliu	h a z u l i w
pârjolește	p a@ r zh o l e sh t e
fetișoara	f e t i sh o@ a r a
țiar	ts j a r
crucean	k r u ch e@ a n
înălbit	a@ n @ l b i t
fântână	f a@ n t a@ n @
auzil	a u z i l
strâmba	s t r a@ m b a
prietenește	p r i e t e n e sh t e
drac	d r a k
lași	l a sh ij
pânom	p a@ n o m
acelea	a ch e l e@ a
cihăit	ch i h @ i t
aprins	a p r i n s
întorci	a@ n t o r ch ij
ascultă	a s k u l t @
greșești	g r e sh e sh t ij
frământa	f r @ m a@ n t a
gândurile	g a@ n d u r i l e
obiceiul	o b i ch e j u l
intrând	i n t r a@ n d
mehenghe	m e h e n g e
lepădat	l e p @ d a t
pâșină	p a@ sh i n @
carea	k a r e@ a
culege	k u l e dz e
buburuzi	b u b u r u z ij
punândui	p u n a@ n d u j
dosul	d o s u l
mâinii	m a@ j n i j
buburuz	b u b u r u z
zbura	z b u r a
întracolo	a@ n t r a k o l o
pârpăra	p a@ r p @ r a
însuratului	a@ n s u r a t u l u j
peri	p e r ij
ferești	f e r e sh t ij
arde	a r d e
focun	f o k u n
sughița	s u g i ts a
ofta	o f t a
puișor	p u i sh o r
căreia	k @ r e j a
jucau	zh u k a w
șerpoaică	sh e r p o@ a j k @
învățase	a@ n v @ ts a s e
șiretul	sh i r e t u l
dres	d r e s
sfârâi	s f a@ r a@ i
boldul	b o l d u l
satanei	s a t a n e j
înghimpase	a@ n g i m p a s e
pară	p a r @
parcămi	p a r k @ m ij
sorb	s o r b
dragă	d r a g @
coastă	k o@ a s t @
nemurind	n e m u r i n d
scoateo	s k o@ a t e@ o
înșfacă	a@ n sh f a k @
tâlcuri	t a@ l k u r ij
cimilituri	ch i m i l i t u r ij
pâcâlit	p a@ k a@ l i t
răbdare	r @ b d a r e
tatăsău	t a t @ s @ w
picat	p i k a t
mâneci	m a@ n e ch ij
largi	l a r dz ij
nunta	n u n t a
zestre	z e s t r e
iubeau	j u b e@ a u
hulubași	h u l u b a sh ij
aleso	a l e s o
gândești	g a@ n d e sh t ij
trântește	t r a@ n t e sh t e
blajină	b l a zh i n @
scoasă	s k o@ a s @
împlinește	a@ m p l i n e sh t e
socru	s o k r u
ierte	j e r t e
asculta	a s k u l t a
argățel	a r g @ ts e l
dovedi	d o v e d i
ierta	j e r t a
ierți	j e r ts ij
uncrop	u n k r o p
scoatem	s k o@ a t e m
coasta	k o@ a s t a
încalecă	a@ n k a l e k @
alăture	a l @ t u r e
tupilată	t u p i l a t @
tălpoi	t @ l p o j
sfredelul	s f r e d e l u l
drumeț	d r u m e ts
juruieștei	zh u r j e sh t e j
cerul	ch e r u l
smomească	s m o m e@ a s k @
credincioasă	k r e d i n ch j o a s @
săra	s @ r a
miaș	m i a sh
cruțăți	k r u ts @ ts ij
încredințeze	a@ n k r e d i n ts e z e
deseară	d e s e@ a r @
baba	b a b a
clatină	k l a t i n @
bogat	b o g a t
deacele	d e@ a k e l e
plosca	p l o s k a
oblânc	o b l a@ n k
babei	b a b e j
gâturi	g a@ t u r ij
întinde	a@ n t i n d e
țoșcă	ts o sh k @
mătușă	m @ t u sh @
voit	v o i t
punga	p u n g a
mâncatear	m a@ n k a t e@ a r
puricii	p u r i ch i j
pârdalnica	p a@ r d a l n i k a
plesnește	p l e s n e sh t e
obrazul	o b r a z u l
înfățișez	a@ n f @ ts i sh e z
celea	ch e l e@ a
vorbe	v o r b e
greș	g r e sh
bărbatu	b @ r b a t u
codoșca	k o d o sh k a
alunece	a l u n e ch e
trezeșteți	t r e z e sh t e ts ij
înceapă	a@ n ch e@ a p @
plânge	p l a@ n dz e
pișcăl	p i sh k @ l
câteoleacă	k a@ t e@ o l e@ a k @
țipa	ts i p a
tatu	t a t u
supărăcios	s u p @ r @ ch j o s
albie	a l b i e
chicoti	k i k o t i
mărunte	m @ r u n t e
amețește	a m e ts e sh t e
covățică	k o v @ ts i k @
venind	v e n i n d
laso	l a s o
costița	k o s t i ts a
întoarcem	a@ n t o@ a r ch e m
amețeală	a m e ts e@ a l @
boci	b o ch i
folos	f o l o s
intrase	i n t r a s e
acui	a k u j
nevastă	n e v a s t @
împietrită	a@ m p i e t r i t @
înșomoltăcim	a@ n sh o m o l t @ ch i m
motanul	m o t a n u l
albiuță	a l b i u ts @
ieșim	j e sh i m
sări	s @ r ij
topească	t o p e@ a s k @
creadă	k r e@ a d @
tămăduim	t @ m @ d u i m
leac	l e@ a k
adăpost	a d @ p o s t
îngriji	a@ n g r i zh i
teom	t e@ o m
înduplecă	a@ n d u p l e k @
motan	m o t a n
plângeau	p l a@ n dz e@ a u
udau	u d a w
copilașul	k o p i l a sh u l
zbuciumânduse	z b u ch j u m a@ n d u s e
mângâie	m a@ n g a@ j e
trimite	t r i m i t e
argat	a r g a t
fiicăsa	f i i k @ s a
arătânduse	a r @ t a@ n d u s e
nenorocire	n e n o r o ch i r e
mătușică	m @ t u sh i k @
vârăte	v a@ r @ t e
sacul	s a k u l
buci	b u ch ij
saci	s a ch ij
ticălos	t i k @ l o s
plângând	p l a@ n g a@ n d
găsească	g @ s e@ a s k @
întâmplate	a@ n t a@ m p l a t e
argatul	a r g a t u l
tătânesău	t @ t a@ n e s @ w
tăbârcesc	t a@ b a@ r ch e s k
căsoaie	k @ s o@ a j e
argatului	a r g a t u l u j
pică	p i k @
întâmplarea	a@ n t a@ m p l a r e@ a
înțelesese	a@ n ts e l e s e s e
deom	d e@ o m
harnici	h a r n i ch ij
sfădești	s f @ d e sh t ij
vorbeau	v o r b e@ a u
ciocan	ch j o k a n
daltă	d a l t @
clești	k l e sh t ij
tângui	t a@ n g u i
cinătuim	ch i n @ t u i m
cozi	k o z ij
număra	n u m @ r a
coastele	k o@ a s t e l e
dalta	d a l t a
ciocanul	ch j o k a n u l
cleștele	k l e sh t e l e
așază	a sh a z @
rană	r a n @
tămăduiește	t @ m @ d u j e sh t e
cumsecade	k u m s e k a d e
frâu	f r a@ w
unghiile	u n g i i l e
pună	p u n @
coarne	k o@ a r n e
încleștat	a@ n k l e sh t a t
înghețat	a@ n g e ts a t
sărută	s @ r u t @
slujit	s l u zh i t
putregai	p u t r e g a j
trebuiește	t r e b u j e sh t e
nevăzut	n e v @ z u t
lăsa	l @ s a
grijile	g r i zh i l e
mâhnit	m a@ h n i t
pierderea	p i e r d e r e@ a
mulțumească	m u l ts u m e@ a s k @
atâtea	a t a@ t e@ a
binefaceri	b i n e f a ch e r ij
primise	p r i m i s e
desfăta	d e s f @ t a
sânul	s a@ n u l
gemea	dz e m e@ a
plângea	p l a@ n dz e@ a
izbăvit	i z b @ v i t
flutura	f l u t u r a
păzițivă	p @ z i ts i v @
spuneți	s p u n e ts ij
verzi	v e r z ij
pățitul	p @ ts i t u l
